andarasan	अंडर्न	अँडरसन

andarasana	अंडर्न	अँडरसन

andarashana	अंडर्न	अँडरसन

andarsan	अंडर्न	अँडरसन

andarsen	अँडर्न	अँडरसन

andarson	अँडर्	अँडरसन

andersan	अँडे्न	अँडरसन

andersen	अँडर्न	अँडरसन

andershon	अँडे्न	अँडरसन

anderson	अँडे्न	अँडरसन

undarson	उँडरस	अँडरसन

undersan	उँडर्न	अँडरसन

undershon	उँडे्न	अँडरसन

underson	उँडर्	अँडरसन

ankoor	अंकूर	अंकुर

ankur	अंकूर	अंकुर

ankurit	अंकुरीत	अंकुरित

angai	अंगाय	अंगाई

angarakee	अंगारकी	अंगारकी

angarkee	अंगारकी	अंगारकी

angarki	अंगार्ी	अंगारकी

aintartic	एंटरर्टिटिक	अंटार्क्टिक

aintartik	एयतरर्टिटिक	अंटार्क्टिक

aintartiq	एयटरर्टिटिक	अंटार्क्टिक

antarktika	अंतरर्किटिक	अंटार्क्टिक

antarqtiqa	अंतरर्किटिक	अंटार्क्टिक

antartic	अंतररिकिट	अंटार्क्टिक

entartic	इंतरर्टिट	अंटार्क्टिक

entartik	एंटरर्टिटिक	अंटार्क्टिक

antarangacha	अंतर्गाचा	अंतरंगाचा

antarman	अंतरममा	अंतर्मन

antarmanat	अंतरममनात	अंतर्मनात

antarmukh	अंतरुमुख	अंतर्मुख

antee	अंती	अंती

anti	अँती	अंती

antharunala	अंथरुना	अंथरुणाला

anthroonala	अंथरूनाला	अंथरुणाला

anthrunala	अंथरूनाला	अंथरुणाला

andhakaarmay	अंधकारमय	अंधकारमय

andhakaramay	अंधकारमय	अंधकारमय

andhakarmay	अंधकमरमय	अंधकारमय

andhkarmay	अंधकमरम्	अंधकारमय

ambar	अंबर	अंबर

ambara	अंबर	अंबर

amber	अंबर	अंबर

ambarat	अंबरात	अंबरात

aksh	आक्ष	अक्ष

akshamya	अक्षम्या	अक्षम्य

akshmy	आक्ष््य	अक्षम्य

akshyamya	अक्ष््या	अक्षम्य

aksharashah	अक्षराा	अक्षरशः

aksharashaha	अक्षराा	अक्षरशः

aksharksha	अक्षरकककााा	अक्षरशः

agadi	अगडी	अगदी

agdi	एग्ी	अगदी

agadeech	अगदीच	अगदीच

agdeech	अगदीच	अगदीच

agdich	अगदीच	अगदीच

agr	एग्र	अग्र

agra	अग्रा	अग्र

achook	अचूक	अचुक

achuk	अचूक	अचुक

achookta	अचूकता	अचुकता

achukata	अचूकता	अचुकता

achukta	अचककता	अचुकता

ajinkyapad	अजिनक्पपा	अजिंक्यपद

ajeet	अजित	अजित

ajiit	अजित	अजित

ajit	अजित	अजित

ajita	अजिता	अजित

azeet	अजित	अजित

azit	अजित	अजित

azita	अजिता	अजित

ajitdada	अजितदाद	अजितदादा

atakav	अटकाव	अटकाव

atkaav	अटकाव	अटकाव

adachan	आडचण	अडचण

adchan	अडचण	अडचण

adathala	अडथला	अडथळा

adavale	अडवले	अडवले

atishay	अतिशय	अतिशय

atishaya	अतिषाा	अतिशय

atyalp	अत्या्प	अत्यल्प

atyalpa	अत्यापप	अत्यल्प

adrushy	अदृष्य	अदृश्य

adrushya	अदृष्य	अदृश्य

adhikach	अधिका	अधिकच

adhikch	अधीकच	अधिकच

adhikachya	अधिका्या	अधिकच्या

adhikchya	अधिक््या	अधिकच्या

adhikaat	अधिकात	अधिकात

adhikat	अधिकतत	अधिकात

adhiniyamachya	अधिनीमााच्या	अधिनियमाच्या

adhiniyamat	अधिन्माात	अधिनियमात

adhiniyamateel	अधिन्माततील	अधिनियमातील

adhiniyamatil	अधिन्माातील	अधिनियमातील

adhikshak	अधिक्षक	अधीक्षक

adhyakshannee	अध्यक्षांनी	अध्यक्षांनी

adhyakshanni	अध्यक्षांनी	अध्यक्षांनी

adhyakshache	अध्यक्षाचे	अध्यक्षाचे

adhyaksheey	अध्यक्षीय	अध्यक्षीय

adhyakshiy	अध्यक्षीय	अध्यक्षीय

adhyapan	अध्यपपन	अध्यापन

adhyapanachee	अध्यापणाची	अध्यापनाची

adhyapanachi	अध्यापनाची	अध्यापनाची

adhyapanachya	अध्यापनाच्या	अध्यापनाच्या

adhyay	अध्याय	अध्याय

adhyayat	अध्यययात	अध्यायात

ananas	आनाा	अननस

anabhishikt	अनभिष्क्त	अनभिषिक्त

anabhishikta	अनभिष्कतत	अनभिषिक्त

anbhishikt	अनभिष्क	अनभिषिक्त

anathalay	अनाथललय	अनाथालय

anavadhanane	अनावधनननने	अनावधानाने

anavdhanane	आनववधननाने	अनावधानाने

anavaran	अनावरण	अनावरण

anutsuk	अनुत्तूक	अनुत्सुक

anooyayancha	अनुयायांचा	अनुयायांचा

anuyaayancha	अनुयायांचा	अनुयायांचा

anuyayancha	अनुयायचचचा	अनुयायांचा

anooyayanche	अनुयायांची	अनुयायांचे

anuyaayanche	अनुयायांचे	अनुयायांचे

anuyayanche	अनुयायचंचे	अनुयायांचे

anooyayanna	अनुयायनंना	अनुयायांना

anuyaayanna	अनुयायननना	अनुयायांना

anuyayanna	अनुयायनंना	अनुयायांना

anooyayee	अनोयायी	अनुयायी

anuyaayi	अनुयायी	अनुयायी

anuyayee	अनुयायी	अनुयायी

anuyayi	अनुयायी	अनुयायी

anuvad	अनुवाद	अनुवाद

anuvadahi	अनुवादाी	अनुवादही

anuvadhee	अनुवाधीी	अनुवादही

anuvadache	अनुवादाचे	अनुवादाचे

anuvadachya	अनुवादाच्या	अनुवादाच्या

anuvadasathee	अनुवददासाठी	अनुवादासाठी

anuvadasathi	अनुवादासाठी	अनुवादासाठी

apatye	आपत्ये	अपत्ये

aparaadh	आपााध	अपराध

aparadh	अपा्ध	अपराध

aparadhachee	अपााधाची	अपराधाची

aparadhachi	अपााधाची	अपराधाची

aparadhee	अपााधी	अपराधी

aparadhi	अपााधी	अपराधी

apavyay	आपव्या	अपव्यय

apuree	आपूरी	अपुरी

apuri	अपुरी	अपुरी

apoorva	अपोर्व	अपूर्वा

apurva	अपूर्व	अपूर्वा

afaganistan	अफगिनीस्तान	अफगाणिस्तान

afghanistan	अफगानीस्तान	अफगाणिस्तान

afaganistancha	अफाांीस्ताचाा	अफगाणिस्तानचा

afghanistancha	अफाणनीस्थाचाा	अफगाणिस्तानचा

afaganistanchya	अफगससीसततींच्या	अफगाणिस्तानच्या

afghanistanchya	अफाणंीस्तींच्या	अफगाणिस्तानच्या

afaganistanmadheel	अफाननीस्ताममधील	अफगाणिस्तानमधील

afghanistanmadhil	अफगणनीस्तांमधील	अफगाणिस्तानमधील

afaganistanmadhye	अफगननीस्ताममध्ये	अफगाणिस्तानमध्ये

afghanistanmadhye	अफगणनीस्ताममध्ये	अफगाणिस्तानमध्ये

afaganistanla	अफगननीस्टललला	अफगाणिस्तानला

afghanistanala	अफाणनीस्तालाा	अफगाणिस्तानला

afghanistanla	अफगणनीस्टाल	अफगाणिस्तानला

abadhit	अबाधित	अबाधित

abj	बब्ज	अब्ज

abja	अबजजा	अब्ज

abhiyaan	अभियान	अभियान

abhiyan	अभियान	अभियान

amarapurkar	अमराफुर्र	अमरापूरकर

amrapoorkar	अमरापूर्र	अमरापूरकर

amrapurkar	अमरापुर्	अमरापूरकर

amaan	अमान	अमान

amanat	अमाना	अमानत

aroonkumar	आरुणकूमार	अरुणकुमार

arunkumar	अरुणकुमार	अरुणकुमार

aroona	आरूण	अरुणा

aruna	अरुणा	अरुणा

arunaa	अरूणा	अरुणा

arc	आर्क	अर्क

ark	एर्क	अर्क

alabama	अलाबाम	अलाबामा

albama	अल्बमम	अलाबामा

ulbama	उल्ंमम	अलाबामा

altra	अल्ट्र	अल्ट्रा

ultra	उल्टरर	अल्ट्रा

alpasankhyakanche	अल्पांख्यांांचे	अल्पसंख्याकांचे

alpsankhyakanche	अल्पसंख्यांांचे	अल्पसंख्याकांचे

alpsankyakanche	अल्पसंक्यांांचे	अल्पसंख्याकांचे

alpavadhit	अल्पववधीत	अल्पावधीत

alpvadheet	अल्पववधीत	अल्पावधीत

alpavadhitach	अल्पववििचच	अल्पावधीतच

alpavadhitacha	अल्पववधिचाा	अल्पावधीतच

alpopahar	अल्पूपहरर	अल्पोपहार

alpophaar	अल्पूहहरर	अल्पोपहार

alpophar	अल्पूहररर	अल्पोपहार

avakala	अवकाा	अवकळा

avakalha	अवकाा	अवकळा

avkalaa	अवकाा	अवकळा

avakashyan	अवकाशानन	अवकाशयान

avkaashyan	अवकाशयनन	अवकाशयान

avkashayan	अवकाशानन	अवकाशयान

avkashyan	अवकाशय्न	अवकाशयान

avayav	अवया	अवयव

awayaw	अवया	अवयव

avayavanchi	अवयााननी	अवयवांची

avayawanchi	अवयाानची	अवयवांची

avyavanchi	अव्ाननची	अवयवांची

awayawanchi	अवयाननची	अवयवांची

avayavanche	अवयाानचे	अवयवांचे

avayawanche	अवयाानचे	अवयवांचे

avyavanche	अव्वानचे	अवयवांचे

awayawanche	अवयाानचे	अवयवांचे

avayavanchya	अवयाानच्या	अवयवांच्या

avayawanchya	अवयाानच्या	अवयवांच्या

avyavanchya	अव्ाानच्या	अवयवांच्या

awayawanchya	अवयाांच्या	अवयवांच्या

avayavanna	अवयाानना	अवयवांना

avayawanna	अवयवानना	अवयवांना

avyavanna	अव्वानना	अवयवांना

awayawanna	अवयवानना	अवयवांना

award	अवरर्ड	अवार्ड

ashikshit	आशिक्षित	अशिक्षित

asam	आसा	असं

asn	आसं	असं

asanch	आसंच	असंच

asantulit	असससूलित	असंतुलित

asahi	असाही	असंही

asanhi	असाही	असंही

asat	असत	असत

asatya	असत्या	असत्या

asatyaa	असत्या	असत्या

astya	अस््या	असत्या

asalee	असले	असली

asali	असली	असली

asli	असली	असली

asalelee	असलेली	असलेली

asleli	असलेली	असलेली

asalele	असलेले	असलेले

aslel	असलेल	असलेले

aslele	असलेले	असलेले

asalelya	असलेल्या	असलेल्या

aslalaya	असलालाया	असलेल्या

aslelya	असलेल्या	असलेल्या

asahay	असायय	असहाय

ashaya	अशायय	असहाय

asaadhy	आसाध्य	असाध्य

asadhaya	असाधयया	असाध्य

asadhy	असाध्य	असाध्य

asava	असावा	असावा

asaavi	असावी	असावी

asavee	असावी	असावी

asavi	असावी	असावी

asaavit	असावित	असावीत

asaveet	असावीत	असावीत

asavit	असावित	असावीत

asave	असावे	असावे

asavet	असावेत	असावेत

aseef	असेफ	असिफ

asif	आसिफ	असिफ

asiph	आसिफ	असिफ

asoonasuddha	असूनाुद्ध	असूनसुद्धा

asoonsuddha	असोंसुद्ध	असूनसुद्धा

asunsuddha	असुंुुद्ध	असूनसुद्धा

astanantar	अस्तानंतर	अस्तानंतर

astitv	असततित्व	अस्तित्व

astitva	अस्तित्व	अस्तित्व

astitvach	अस्तित्वा	अस्तित्वच

astitvacha	असततित्वाचा	अस्तित्वाचा

astitvachee	असततिव्वाची	अस्तित्वाची

astitvachi	असततित्वाची	अस्तित्वाची

astitvateel	अस्तित्वातील	अस्तित्वातील

astitvatil	अस्तित्वातील	अस्तित्वातील

asthayi	असाथायी	अस्थायी

asmita	अस्मिता	अस्मिता

ahamadabadchya	अहमाबबादच्या	अहमदाबादच्या

ahemdabadchya	अहमदुबालच्या	अहमदाबादच्या

ahmedabadchya	अहमदुबददल्या	अहमदाबादच्या

ahamadabadla	अहमदबबददला	अहमदाबादला

ahemadabadla	अहमदाबदलला	अहमदाबादला

ahmadabadla	अहमदाबददला	अहमदाबादला

aaikadoon	आयकडून	आईकडून

aaikadun	आयकडून	आईकडून

aaichee	आयची	आईची

aaichi	आयची	आईची

aaichya	आयच्या	आईच्या

aaila	आयल	आईला

aakarmanacha	आकारमानाचा	आकारमानाचा

kakarmanacha	ककारमानचचा	आकारमानाचा

aakarmanachi	आकारमानाची	आकारमानाची

aakarmanane	आकारमानाने	आकारमानाने

aakrutya	आकृत्या	आकृत्या

aagade	आगडे	आगळे

aagale	आगले	आगळे

aagle	आगले	आगळे

aagekooch	आगेकचच	आगेकूच

aagekuch	आगेकूच	आगेकूच

aajatagayat	अजतागातत	आजतागायत

aajtagayat	आततागातत	आजतागायत

aajaranche	आजारांचे	आजारांचे

ajaranche	आजररांचे	आजारांचे

aajaranchya	आजारांच्या	आजारांच्या

ajaranchya	अजारांच्या	आजारांच्या

aajaranmaddhe	आजारांमध्ये	आजारांमध्ये

aajaranmadhye	आजारांमध्ये	आजारांमध्ये

aajaransathi	आजारांसाठी	आजारांसाठी

aajarakade	आझारककडे	आजाराकडे

ajarakade	अजररककडे	आजाराकडे

aajarachi	आजाराची	आजाराची

ajarachi	अजाराची	आजाराची

aajarachya	आजाराच्या	आजाराच्या

aajarachyaa	आजाराच्या	आजाराच्या

ajarachya	अजाराच्या	आजाराच्या

aajaraat	आजारात	आजारात

aajarat	आजारतत	आजारात

ajarat	अजारतत	आजारात

aajaramadhye	आजारामध्ये	आजारामध्ये

ajaramadhye	अजारामध्ये	आजारामध्ये

aajaramule	आाररामुळे	आजारामुळे

ajaramule	अजररामुळे	आजारामुळे

aajarala	आजररलला	आजाराला

ajarala	अजररलला	आजाराला

aajaaree	आजारी	आजारी

aajaari	आजारी	आजारी

aajari	आजररी	आजारी

aajoobajooche	आजाबाजोचे	आजूबाजूचे

aajubajuche	आजाबागूने	आजूबाजूचे

aajoobajoochya	आजाबागोच्या	आजूबाजूच्या

aajubajuchya	आजाबागूच्या	आजूबाजूच्या

aajunajuchya	आजुनननीं्या	आजूबाजूच्या

aajobanchee	आझोबांची	आजोबांची

aajobanchi	आझोबांची	आजोबांची

aajobanche	आजोबांचे	आजोबांचे

aajobanchya	आजोबांच्या	आजोबांच्या

aath	आथ	आठ

aanlela	आणलेला	आणलेला

aanalele	आणलेले	आणलेले

aanlele	आणलेले	आणलेले

anlele	अणलेले	आणलेले

aanave	आणावे	आणावे

anawe	अणावे	आणावे

aanee	आणी	आणि

aani	आणी	आणि

ani	अणी	आणि

aanel	आणेल	आणेल

aatade	आतडे	आतडे

aadim	आदीम	आदिम

aadee	आदी	आदी

aadi	आदि	आदी

aadii	आदी	आदी

adee	अदी	आदी

adi	एदी	आदी

adii	अदी	आदी

aan	आण	आन

aanandajee	आनंदाी	आनंदजी

anandajee	आनंदाी	आनंदजी

anandji	अनंदाी	आनंदजी

aapaapsat	आपापसात	आपआपसात

aapaapsath	आपापसाठ	आपआपसात

aapasat	आपाात	आपसात

aapsaat	आपाात	आपसात

aamuchi	आमूची	आमुची

aamuchy	आमूच्	आमुची

aamhee	आम्ही	आम्ही

aamhi	आमहही	आम्ही

aaryan	आरर्ण	आयर्न

aayarn	आयर्न	आयर्न

aryan	आरर्ण	आयर्न

ayarn	आयर्न	आयर्न

iran	इरराण	आयर्न

iron	ययरोन	आयर्न

aayaland	आयलंड	आयलंड

iceland	आयल्ड	आयलंड

iland	इयलंड	आयलंड

island	इइस्स	आयलंड

ayoniyan	आयोनिया	आयोनियन

ayooniyan	आयुनिया	आयोनियन

ionan	इयननंना	आयोनियन

ionian	ओयननिया	आयोनियन

ioonian	ओयननिया	आयोनियन

aayova	आयोवा	आयोवा

ayoova	आयोवा	आयोवा

ayoowa	आयोव	आयोवा

ayova	आयोव	आयोवा

ayowa	आयोव	आयोवा

ioova	ओयोवा	आयोवा

ioowa	ओयोवा	आयोवा

iova	ऐयोवा	आयोवा

iowa	ओयववा	आयोवा

aaramsheer	आरममशीर	आरामशीर

aaramshir	आरममशीर	आरामशीर

aarteemis	आरतटेमिस	आर्टेमिस

aartemis	आर्मेमिस	आर्टेमिस

arteemeeas	ऑर्टिमिस	आर्टेमिस

arteemis	आर्टेमिस	आर्टेमिस

artemeas	अर्मेमिय	आर्टेमिस

artemes	अर्टेम	आर्टेमिस

artemis	एर्टेमिस	आर्टेमिस

aarthik	आर्थिक	आर्थिक

aarseenal	आरससिनल	आर्सेनल

aarsenal	आरससिलल	आर्सेनल

aarshenal	आर्शेलल	आर्सेनल

arseenala	अरससिनल	आर्सेनल

arsenala	अरससिलल	आर्सेनल

arshenala	अर्शेलला	आर्सेनल

aala	आला	आला

aalo	आलो	आलो

alo	ओलो	आलो

aavaka	आवकका	आवाका

aavruttee	आवृत्ती	आवृत्ती

aavrutti	आवृत्ती	आवृत्ती

avrutti	अवृत्ती	आवृत्ती

aavritichay	आवितीतीची	आवृत्तीचे

aavruttiche	आवृत्तीचे	आवृत्तीचे

aawritichay	आवितीचीच	आवृत्तीचे

avruttiche	अवृत्तीचे	आवृत्तीचे

aavrateet	आवरत्ती	आवृत्तीत

aavriteet	आवितीति	आवृत्तीत

aavruttit	आवृत्तित	आवृत्तीत

avruttit	आवृत्तित	आवृत्तीत

aashevar	आशेवर	आशेवर

ashevar	अशेवर	आशेवर

aashta	आष्ट	आष्टा

ashta	आष्ट	आष्टा

aasaram	आसारमम	आसाराम

asaram	आसारमम	आसाराम

asarama	आसारममा	आसाराम

aahaat	आहात	आहात

aahat	आहात	आहात

ahaat	अहात	आहात

aahaar	आहार	आहार

aahar	आहार	आहार

ahaar	अहरर	आहार

aahaarakaday	आहाराकडा	आहाराकडे

aahaarakade	आहारककडे	आहाराकडे

aaharakade	आहररककडे	आहाराकडे

aahaarachay	आहरराच्	आहाराचे

aaharache	आहाराचे	आहाराचे

ahaarache	आहरराचे	आहाराचे

aaharat	आहारात	आहारात

ahaarat	आहारात	आहारात

aahet	आहेत	आहेत

engraj	इंग्रा	इंग्रज

ingraj	इंग्रज	इंग्रज

ingrej	इंग्रेी	इंग्रज

engrajancha	इंग्रजांचा	इंग्रजांचा

engrajanchi	इंग्रजांची	इंग्रजांची

engrajanche	इंग्रजांचे	इंग्रजांचे

engrajanna	इंज्रजांना	इंग्रजांना

engrajache	इंग्रजाचे	इंग्रजाचे

ingrajache	इंग्रजाचे	इंग्रजाचे

englandakadoon	इंग्लादकनूक	इंग्लंडकडून

englandkadoon	इंग्लाडकूून	इंग्लंडकडून

englandkadun	इंग्लादकूून	इंग्लंडकडून

englandchya	इंगळलाचच्या	इंग्लंडच्या

englandne	इंग्लाडन	इंग्लंडने

englandmadheel	इंग्लाममधील	इंग्लंडमधील

englandmadhil	इंग्लाममीील	इंग्लंडमधील

englandla	इंगळलाडल	इंग्लंडला

endaus	एंडा	इंडस

endous	एंडो	इंडस

endoush	एंडो	इंडस

endus	एंड्	इंडस

endush	एंदू	इंडस

indas	इंडा	इंडस

indasa	इंडाा	इंडस

indasha	इंडाााा	इंडस

indos	इंडो	इंडस

indosh	इंडो	इंडस

indus	इंडू	इंडस

indush	इंदू	इंडस

indeeks	इंडेक्स	इंडेक्स

indeex	इंडेक्स	इंडेक्स

indeks	इडडेक्स	इंडेक्स

indeqs	इडडेक्स	इंडेक्स

index	इंडेक्स	इंडेक्स

eendoneeshian	इंडोनेशियन	इंडोनेशियन

eendoneesian	एंडोनेशियन	इंडोनेशियन

endonesan	एंडोनेशनयन	इंडोनेशियन

endoneshan	एंडोनशशनयन	इंडोनेशियन

endoneshhian	इंडोनेशिया	इंडोनेशियन

endoneshian	एंडोनेशियन	इंडोनेशियन

endonesian	एंडोनेशियन	इंडोनेशियन

endooneshian	एंडोनेशियन	इंडोनेशियन

endoonesian	एंडोनेशियन	इंडोनेशियन

indoneeshian	इंडोनेशियन	इंडोनेशियन

indoneeshiyan	इंडोनेशिया	इंडोनेशियन

indoneshan	इंडोनेशनया	इंडोनेशियन

indoneshhian	इंडोनेशियन	इंडोनेशियन

indoneshhiyan	इंडोनेशियन	इंडोनेशियन

indoneshian	इंडोनेशियन	इंडोनेशियन

indoneshiyan	इंडोनेशिया	इंडोनेशियन

indonesian	इंडोनेशियन	इंडोनेशियन

indonesiyan	इंडोनेशिया	इंडोनेशियन

indooneshian	इंडोनेशियन	इंडोनेशियन

indooneshiyan	इंडोनेशियन	इंडोनेशियन

indapoor	इंडापूर	इंदापूर

indapur	इंडापूर	इंदापूर

indrajit	इंद्रजित	इंद्रजित

ekbal	एकबबलल	इक्बाल

eqbal	एकबबलल	इक्बाल

ikbal	एक्बलल	इक्बाल

ikbala	एक्बलला	इक्बाल

iqbal	एक्बलल	इक्बाल

iqbala	एक्बलला	इक्बाल

igatapuree	इगताररी	इगतपुरी

igatpuree	इगतपुरी	इगतपुरी

igatpuri	इगतपूरी	इगतपुरी

egoor	एजोर	इगोर

egor	एगोर	इगोर

igoor	यज्र	इगोर

igor	एजरर	इगोर

itaki	इतकी	इतकी

itki	इतकी	इतकी

inaayat	इनायत	इनायत

inayat	इयायत	इनायत

institute	इन्स्टिट्टट	इन्स्टिटयूट

instityoot	इन्स्टिट्टट	इन्स्टिटयूट

emraan	इमरान	इमरान

imaran	इमाणन	इमरान

imran	इमरणन	इमरान

iyatta	आयत्त	इयत्ता

ear	एएर	इयर

er	एरर	इयर

iyar	आयर	इयर

year	ययर	इयर

yer	ययर	इयर

ilakhyaat	इलखख्यात	इलाख्यात

ilakhyat	इळखख्यात	इलाख्यात

ishhk	इशाक	इश्क

ishhq	इशाक	इश्क

ishk	एषाक	इश्क

ishq	इषाक	इश्क

isk	एस्क	इश्क

isq	एस	इश्क

essence	एसेस्स	इसेन्स

isens	एसेन्स	इसेन्स

israel	इस्रायल	इस्राईल

israil	इस्रायल	इस्राईल

eeshanyela	ईशानेयेला	ईशान्येला

ishanyela	ईशानेयेला	ईशान्येला

eeshwarachya	ऐश्वरचच्या	ईश्वराच्या

ishwarachya	इश्वरचच्या	ईश्वराच्या

ishvareey	इश्वरीय	ईश्वरीय

ishwariy	इश्वरीय	ईश्वरीय

ishwariya	इश्वरिय	ईश्वरीय

ugavan	उगवन	उगवण

ugawan	उगवन	उगवण

ugr	गग्र	उग्र

ugra	उग्रा	उग्र

uddanpool	उद्दापूूल	उड्डाणपूल

uddanpul	उद्दांीुळ	उड्डाणपूल

utarati	उतरती	उतरती

utarave	उतरववे	उतरावे

uttar	उत्तर	उत्तर

uttarakashi	उत्तरााशी	उत्तरकाशी

uttarkashi	उत्तरााशी	उत्तरकाशी

uttarahee	उत्तरही	उत्तरही

uttarahi	उत्तरही	उत्तरही

uttarhee	उत्तरही	उत्तरही

uttara	उत्तर	उत्तरा

uttarachya	उत्तराच्या	उत्तराच्या

uttareeya	उत्तरीय	उत्तरीय

uttariy	उत्तरीय	उत्तरीय

uttariya	उत्तरिय	उत्तरीय

utpad	उत्पाद	उत्पाद

utsavachee	उत्सवाची	उत्सवाची

utsavachi	उत्सवाची	उत्सवाची

utsavache	उत्सवाचे	उत्सवाचे

utsavat	उत्सवात	उत्सवात

utsavateel	उत्सवातील	उत्सवातील

utsavatil	उतससवातील	उत्सवातील

utsavane	उत्सवाने	उत्सवाने

utsavala	उत्सवाला	उत्सवाला

udya	उद्या	उद्या

udyachya	उद्याच्या	उद्याच्या

udyogpatee	उद्योगपती	उद्योगपती

udyogpati	उद्योगपती	उद्योगपती

udhaan	उधान	उधाण

udhan	उधान	उधाण

unnaticha	उन्नाीचा	उन्नतीचा

upagrahachi	उपगारहाची	उपग्रहाची

upgrahachi	उपग्रहाची	उपग्रहाची

upagrahache	उपगारहाचे	उपग्रहाचे

upgrahache	उपग्रहाचे	उपग्रहाचे

upagrahachya	उपगृरहाच्या	उपग्रहाच्या

upgrahachya	उपग्रहाच्या	उपग्रहाच्या

upanam	उपनमम	उपनाम

upnam	उपनमम	उपनाम

upayogansathee	उपाोगांसाठी	उपयोगांसाठी

upyogansaathi	उपनोगांसाठी	उपयोगांसाठी

upyogasathi	उपोोगाससाठी	उपयोगांसाठी

upayogacha	उपयोगाचा	उपयोगाचा

upyogacha	उयोोगाचा	उपयोगाचा

upayogachya	उपयोगाच्या	उपयोगाच्या

upyogachya	उपोोगाच्या	उपयोगाच्या

upayogat	उययोगतत	उपयोगात

upyogat	उययोगतत	उपयोगात

upayogee	उपाोगी	उपयोगी

upayogi	यपाोगी	उपयोगी

upyogi	उपोोगी	उपयोगी

uparollekhit	उपरोलोलिखित	उपरोल्लेखित

uprollekhit	उपरोलखखखखित	उपरोल्लेखित

upasarg	उपसर्ग	उपसर्ग

upsarg	उपसर्ग	उपसर्ग

ubhay	उभा	उभय

ubhayatannee	उभयाांनी	उभयतांनी

ubhayatanni	उभााांनी	उभयतांनी

ubhaytanni	उभाा्ंनी	उभयतांनी

ubhe	उभे	उभे

ubhech	उभेच	उभेच

aamesh	आमेश	उमेश

oomeesh	ओमीश	उमेश

oomes	ओम्श	उमेश

oomesh	ओमेश	उमेश

oomeshh	ओमेश	उमेश

umeesh	उमीश	उमेश

umes	उमीस	उमेश

umesh	उमेश	उमेश

umeshh	उमेश	उमेश

urdoo	उर्डो	उर्दू

urdu	उर्डू	उर्दू

urduu	उर्डू	उर्दू

uurdoo	उद्डू	उर्दू

uurduu	उद्डू	उर्दू

urdoocha	उद्डोचा	उर्दूचा

urducha	उद्दुचा	उर्दूचा

ulagadat	उलगड	उलगडत

ualagadale	उलगलेे	उलगडले

ulagadale	उलगलले	उलगडले

ulagadoon	उलगडून	उलगडून

ulagadun	उलगडून	उलगडून

ushnata	उषाणता	उष्णता

usake	उसाे	उसके

usmania	उसममानिया	उस्मानिया

usmaniya	उस्मानिया	उस्मानिया

usatod	ऑसतोड	ऊसतोड

ustod	ऑस्ोड	ऊसतोड

usatodanee	उसतोडाी	ऊसतोडणी

ustodanee	उस्ोदीी	ऊसतोडणी

ustodani	उस्ोदाी	ऊसतोडणी

ekandar	एकादर	एकंदर

ekndar	एकादर	एकंदर

ektis	एक्ीस	एकतीस

eknath	एकााथ	एकनाथ

ekanathanche	एकााथननची	एकनाथांचे

eknathanche	एकााथानची	एकनाथांचे

ekanathanchya	एकााथनंच्या	एकनाथांच्या

eknathanchya	एकााथानच्या	एकनाथांच्या

eknishth	एकाेश्ठ	एकनिष्ठ

eknishtha	एकाेष्ठ	एकनिष्ठ

eknishthata	एकीेष्ठता	एकनिष्ठता

ekmatr	एकमतत्र	एकमात्र

ekmatra	एकमतत्र	एकमात्र

edamantan	एडमंटन	एडमंटन

edmantan	एडमंटन	एडमंटन

edmanton	एडमंटन	एडमंटन

edmonton	एडमंटू	एडमंटन

idamantan	इडमटटन	एडमंटन

idmanton	एडमंटन	एडमंटन

idmonton	एडमनटन	एडमंटन

idmuntan	एडमंटू	एडमंटन

idmunton	एडमंटू	एडमंटन

ma	ममा	एमए

aevadha	एवढा	एवढा

evadha	एवढा	एवढा

aseen	असनन	एसेन

asen	असनन	एसेन

asieen	अशिन	एसेन

asien	एशिन	एसेन

asiin	एशिन	एसेन

asin	एशिन	एसेन

eeseen	एसिन	एसेन

eesseen	इसेन	एसेन

esen	एसनन	एसेन

essen	एसनस	एसेन

isin	एसिन	एसेन

issin	इसिस	एसेन

aesti	इस्टि	एस्टी

estee	इस्टि	एस्टी

esti	इस्टि	एस्टी

aicchik	एकककिक	ऐच्छिक

aichhik	एच्छिक	ऐच्छिक

eachchhik	इच्छाक	ऐच्छिक

aehik	एहिक	ऐहिक

aihik	अहिक	ऐहिक

ehik	एहिक	ऐहिक

oxygenchee	ऑक्सिपनीी	ऑक्सिजनची

oxygenchi	आस्सियनची	ऑक्सिजनची

alampic	अलिं्सिस	ऑलिम्पिक

alimpika	एलिं्पिका	ऑलिम्पिक

alimpiqa	एलिम्पिका	ऑलिम्पिक

alyimpic	आलिम्पिस	ऑलिम्पिक

alympic	आलिं्पिक	ऑलिम्पिक

aulampic	ऑलिं्पिस	ऑलिम्पिक

olampic	ऑलिं्पिस	ऑलिम्पिक

olimpik	ऑलिं्पिक	ऑलिम्पिक

olyimpic	ऑलिंिपिय	ऑलिम्पिक

olympic	ऑलिं्पिक	ऑलिम्पिक

aulivhar	ओलिहरहर	ऑलिव्हर

oliver	ओलिवररर	ऑलिव्हर

olivhar	ओलिवाहा	ऑलिव्हर

aundaka	ओंडका	ओंडका

ondaka	ओंडका	ओंडका

odisa	ओडिसा	ओडिसा

olandala	ओळंंडाा	ओलांडला

olandla	ओळांडाा	ओलांडला

olandalee	ओळांडळी	ओलांडली

olandali	ओळांडळी	ओलांडली

olandlee	ओळांडीी	ओलांडली

ovalanee	ओवाळणी	ओवाळणी

ovalani	ओवाळाी	ओवाळणी

avya	अव्या	ओव्या

ovya	ओव्या	ओव्या

ovyaa	ओव्या	ओव्या

owya	ओव्या	ओव्या

audhyogikeekaran	औद्योगिकीीककक	औद्योगिकरण

audyogikaran	औद्योगिकाण	औद्योगिकरण

aushadh	औषा	औषध

aushadhanchya	उषाानच्या	औषधांच्या

aushadhannee	उषााननी	औषधांनी

aushadhanni	उषाांनी	औषधांनी

aushadhansathee	उषाांसाठी	औषधांसाठी

aushadhansathi	उषाांताठी	औषधांसाठी

aushadhacha	उषााचा	औषधाचा

aushadhache	उषााचे	औषधाचे

aushadhat	उषातत	औषधात

kangore	कागोर	कंगोरे

kantaloon	कंटललून	कंटाळून

kantalun	काटालून	कंटाळून

kambarechya	कंबरीच्या	कंबरेच्या

kachara	कचा	कचरा

kachra	का्	कचरा

kachari	काारी	कचेरी

kacheree	कचेरी	कचेरी

kacharichya	कचारचच्या	कचेरीच्या

kachereechya	काेरीच्या	कचेरीच्या

kathin	कथीन	कठिण

kada	कडा	कडा

kathak	कथक	कथक

kathakalee	काकाी	कथकली

kathakali	कथााी	कथकली

kadar	कडर	कदर

kanak	काक	कनक

kanada	कॅाददा	कन्नड

kannad	कॅ्नड	कन्नड

kannada	कॅ्नाा	कन्नड

qannada	कॅ्दडा	कन्नड

kanyaka	कन्याा	कन्यका

kapoorachya	कपोरच्या	कपूरच्या

kapoorchya	काोरच्या	कपूरच्या

kapurchya	काौरच्या	कपूरच्या

kabulee	काुली	कबुली

kabuli	काुली	कबुली

kabr	कबरर	कब्र

kabra	कबरर	कब्र

kamalakar	कालककर	कमलाकर

cammand	कमांडा	कमांड

comand	कमांड	कमांड

command	कमांड	कमांड

commond	कमोंड	कमांड

comond	कॉोंड	कमांड

kamand	कमांड	कमांड

kamanda	कमांडा	कमांड

kammand	कमांड	कमांड

qamanda	कमांडा	कमांड

qammand	कमांड	कमांड

karandikar	कांदीकर	करंदीकर

karanaara	काणारा	करणारा

karanara	काणारा	करणारा

karanehee	करणेही	करणेही

karanehi	करणेही	करणेही

karavilee	करविली	करविली

karavili	करविली	करविली

karvilee	करविली	करविली

karachee	कराची	कराची

karachi	कराची	कराची

karachii	कराची	कराची

qarachi	कराची	कराची

karamat	करममा	करामत

karava	काावा	करावा

karu	करु	करु

kareparyant	काेपर्यंत	करेपर्यंत

karna	कर्न	कर्णा

karnacha	कर्नाचा	कर्णाचा

karnala	कर्नाला	कर्णाला

karnik	का्नीक	कर्णिक

kartabagareene	कर्तबााराने	कर्तबगारीने

kartabgareene	का्तबै्रीने	कर्तबगारीने

kartabgarine	का्तबा्रीने	कर्तबगारीने

karmachya	कर्माच्या	कर्माच्या

karmat	कर्मतत	कर्मात

karme	कर्मे	कर्मे

calar	कार	कलर

calur	कार	कलर

color	कोो	कलर

colour	कोू	कलर

colur	कोू	कलर

kalar	काा	कलर

qalar	काा	कलर

kalatani	काततणी	कलाटणी

kaltanee	कलततणी	कलाटणी

kalika	कािका	कलिका

kalekalene	काेकाेने	कलेकलेने

kaleklene	काेकलेन	कलेकलेने

kallol	का्लूल	कल्लोळ

kalhai	का्हा	कल्हई

kalapat	काातत	कळपात

kalalele	कळलेले	कळलेले

kasheli	काेली	कशेळी

kashtachee	कष्टाची	कष्टाची

kashtachi	कष्टाची	कष्टाची

kashtache	कष्टाचे	कष्टाचे

kashtane	कष्टाने	कष्टाने

kasabasa	कसबबसा	कसाबसा

kasotya	कसोट्या	कसोट्या

concrete	कांक्रेटे	काँक्रिट

konkrit	कोँक्रिट	काँक्रिट

ka	का	कां

kan	कानन	कां

kanchi	कांची	कांची

canto	कांटो	कांतो

cantoo	कांतू	कांतो

kanto	कांतो	कांतो

kantoo	कांतू	कांतो

qanto	कांतो	कांतो

kathamandoo	कथथांंडू	काठमांडू

kathamandu	कथथांंडू	काठमांडू

kathamanduu	कथथांंडू	काठमांडू

kathmandu	कथथमंंडू	काठमांडू

kathmanduu	काथाधंडू	काठमांडू

kethamandu	केठेांडू	काठमांडू

kethmandu	कथठेंंडू	काठमांडू

qathamandu	कथथांंड	काठमांडू

qathmandu	कथथमंंडू	काठमांडू

kadhava	काढववा	काढावा

kanakonakar	कानकोनकर	काणकोणकर

kankonkar	कानकोककर	काणकोणकर

katadee	कातडी	कातडी

katadi	कातडी	कातडी

katadeecha	कततदीचा	कातडीचा

katadicha	कातडीचा	कातडीचा

katal	कटतळ	कातळ

katalat	कातळतत	कातळात

kapus	कापुस	कापुस

kabadkasht	कबबददस््ट	काबाडकष्ट

kabadkashta	कबबददस््ट	काबाडकष्ट

kamothe	कामोठे	कामोठे

kayada	कययदा	कायदा

kayda	कायदा	कायदा

kayadebhang	कायदेभंग	कायदेभंग

kaydebhang	कायदेबंग	कायदेभंग

kayadya	कायद्य	कायद्या

kaydya	कायद्य	कायद्या

kayadyanchi	काया्यांची	कायद्यांची

kaydyanchee	कायद्यांची	कायद्यांची

kaydyanchi	कायद्यांची	कायद्यांची

kayadyanche	काया्यांचे	कायद्यांचे

kaydyanche	कायद्यांचे	कायद्यांचे

kayadyanchya	कायद्यांच्या	कायद्यांच्या

kaydyanchya	कायद्यांच्या	कायद्यांच्या

kayadyacha	कायद्याचा	कायद्याचा

kaydyacha	कायद्याचा	कायद्याचा

kayadyachya	काया्याच्या	कायद्याच्या

kaydyachya	कायद्याच्या	कायद्याच्या

kayadyat	कायद्यात	कायद्यात

kaydyat	कायद्यात	कायद्यात

kayadyane	कायद्याने	कायद्याने

kaydyane	कायद्याने	कायद्याने

kayadyapramane	काया्यपप्रमाणे	कायद्याप्रमाणे

kaydyapramane	कायद्यपप्रमाणे	कायद्याप्रमाणे

kayadyamadhye	कायद्यामध्ये	कायद्यामध्ये

kaydyamadhye	कायद्यामध्ये	कायद्यामध्ये

kayadyamule	कायद्यामुळे	कायद्यामुळे

kaydyamule	कायद्यामुळे	कायद्यामुळे

kayadyala	काया्याला	कायद्याला

kaydyala	कायद्याला	कायद्याला

kayadyas	काया्यास	कायद्यास

kaydyas	कायद्यास	कायद्यास

kayam	कायम	कायम

kayamach	कायमच	कायमच

kayamch	कायमच	कायमच

kayamachi	कायमाी	कायमची

kayamchee	कायमची	कायमची

kayamchi	कायमची	कायमची

kayamche	कायमचे	कायमचे

karanja	कररंज	कारंजा

karanjee	कररंजी	कारंजी

karanji	कररंजी	कारंजी

karakhandar	कारखांदार	कारखानदार

karkhandar	कारखां्ार	कारखानदार

karyakartyanche	कार्यका्तायांचे	कार्यकर्त्यांचे

karyakartyanna	कार्यकर्तनयांना	कार्यकर्त्यांना

karyakartyanee	कार्यका्त्याननी	कार्यकर्त्यांनी

karyakartyannee	कार्यका्तायांनी	कार्यकर्त्यांनी

karyakartyanni	कार्यकाकतायांनी	कार्यकर्त्यांनी

karyakaal	कार्यकाल	कार्यकाल

karyakal	कार्यकाल	कार्यकाल

karyavaahi	कार्यााही	कार्यवाही

karyavahee	कार्यााही	कार्यवाही

karyavahi	कार्यााही	कार्यवाही

karyalay	कार्यालय	कार्यालय

karyalayache	कार्यालयाचे	कार्यालयाची

karyalayachee	कार्यालयाची	कार्यालयाची

karyalayachi	कार्यालयाची	कार्यालयाची

karyalayaat	कार्यालयात	कार्यालयात

karyalayat	कार्यालयात	कार्यालयात

karyalayateel	कार्याययातील	कार्यालयातील

karyalayatil	कार्याययातील	कार्यालयातील

karyalayane	कार्यालयाने	कार्यालयाने

karyalayala	कार्यालयाला	कार्यालयाला

karyalayavar	कार्यालयावर	कार्यालयावर

karyalayawar	कार्यालयावर	कार्यालयावर

karyalayashee	कार्याल्ाशी	कार्यालयाशी

karyalayashi	कार्याल्ाशी	कार्यालयाशी

kalava	कालवा	कालवा

kalva	कालवा	कालवा

kalwa	कालवा	कालवा

kaliya	काळिया	कालिया

kalapasoon	कालापासून	काळापासून

kalapasun	कालापासून	काळापासून

kaleehee	कालीही	काळीही

kalihee	कालीही	काळीही

kalihi	कालीही	काळीही

kavad	कववड	कावड

kawad	कववळ	कावड

kaveel	कावील	कावीळ

kavil	कववील	कावीळ

kasheet	काशीत	काशीत

kashit	काशीत	काशीत

kasavanchee	कससाांची	कासवांची

kasawanchi	कससाांची	कासवांची

kasavanchya	कससाांच्या	कासवांच्या

kasavavnchya	कससवावव्यांच्	कासवांच्या

kasawanchya	कससाांच्या	कासवांच्या

kasavache	कससााचे	कासवाचे

kasawachi	कससााची	कासवाचे

kasegao	कससेगाव	कासेगाव

kasegaon	कससेगाव	कासेगाव

kasegav	कससेगाव	कासेगाव

kideenchee	किडींची	किडींची

kideenchi	किडींची	किडींची

kidinchi	किडींची	किडींची

kideenche	किडींचे	किडींचे

kidinche	किडींचे	किडींचे

kinaryala	किनाऱ्याला	किनाऱ्याला

kinaryavar	किनाऱ्यावर	किनाऱ्यावर

kinaryavareel	किनाऱ्यावरील	किनाऱ्यावरील

kinaryavaril	किनाऱ्यावरील	किनाऱ्यावरील

kiranotsargee	किरोोकगसगिगी	किरणोत्सर्गी

kiranotsargi	किरोोकककगिगी	किरणोत्सर्गी

kisanrao	किसाराव	किसनराव

kisanrav	किसाराव	किसनराव

keertichya	किर्तीच्या	कीर्तीच्या

kirtichya	किर्कीच्या	कीर्तीच्या

kundalee	कुंडाी	कुंडली

kundali	कुंडाी	कुंडली

kundaleet	कुंडळीत	कुंडलीत

kundalit	कुंदळीत	कुंडलीत

kundlit	कुंडळित	कुंडलीत

kutoombateel	कुटुंबातील	कुटूंबातील

kutumbateel	कुटुंबातील	कुटूंबातील

kutumbatil	कुटुंबातील	कुटूंबातील

kunakeshvar	कुणकेश्वर	कुणकेश्वर

kunkeshvar	कुककेश्वर	कुणकेश्वर

kunkeshwar	कुककेश्वर	कुणकेश्वर

kutuhal	कुतुलल	कुतूहल

kutre	कुत्रे	कुत्रे

kumak	कुमक	कुमक

kumarchya	कुमारा्या	कुमारच्या

kumarne	कुमाराा	कुमारने

kurtakoti	कुर्तकोटी	कुर्तकोटी

kurtkoti	कुर्ककोटी	कुर्तकोटी

kuladeep	कुलदीप	कुलदीप

kuldeep	कुलदीप	कुलदीप

kuldip	कुलदीप	कुलदीप

colabyachya	कोलाबचयाच्या	कुलाब्याच्या

kulabyachya	कुलाब्याच्या	कुलाब्याच्या

kuloop	कुलूप	कुलूप

kulup	कुलुप	कुलूप

krut	कृत	कृत

kritishil	कृतिशील	कृतीशील

kruteesheel	कृतिशील	कृतीशील

krutishil	कृतिशील	कृतीशील

crupa	क्पा	कृपा

kripa	क्पा	कृपा

krupa	क्पा	कृपा

qripa	क्प	कृपा

qrupa	क्पा	कृपा

kripaprasadane	क्प्रसरसांाने	कृपाप्रसादाने

krupaprasadane	कुप्सदरसादनने	कृपाप्रसादाने

krishhna	कृष्ण	कृष्णा

krishna	कृष्ण	कृष्णा

krisna	क्षिसा	कृष्णा

krushhna	कृष्ण	कृष्णा

krushna	कृष्ण	कृष्णा

krusna	क्ष्णा	कृष्णा

qrishna	कृष्ण	कृष्णा

qrushna	कृष्ण	कृष्णा

cancercha	काक्सरचा	कॅन्सरचा

camere	कॅमेर	कॅमेरे

caineeth	सॅनचच	केनेथ

caineth	सॅनेच	केनेथ

ceneth	सेनेच	केनेथ

keeineeth	कीनीठ	केनेथ

keeneeth	किनिठ	केनेथ

keenneeth	केनेथ	केनेथ

keineth	कीनेच	केनेथ

keneth	केनेथ	केनेथ

kenneth	केनेथ	केनेथ

qeineth	किनेच	केनेथ

qeneth	केणेठ	केनेथ

qenneth	केनेट	केनेथ

keenyata	किनियात	केन्याटा

keenyatta	किनियततत	केन्याटा

kenyata	केण्यात	केन्याटा

kenyatta	केन्यतत्	केन्याटा

kenyeta	केनियेत	केन्याटा

kenyetta	केनियेत	केन्याटा

qenyata	केनियात	केन्याटा

qenyatta	केण्यततत	केन्याटा

kaisar	कैसर	कैसर

kaiser	कैसर	कैसर

kaishar	कैशर	कैसर

kaishara	कैशराा	कैसर

kaisher	कैशर	कैसर

kesar	केसर	कैसर

kesara	केसर	कैसर

keser	केसर	कैसर

qaisar	कैसर	कैसर

qaisara	कैसर	कैसर

qaiser	कैसर	कैसर

coimbatore	किंंबारर	कोइंबतूर

cock	कॉक	कोक

coke	कोक	कोक

kok	कूक	कोक

kokilaben	कोकीलाबनन	कोकिलाबेन

cochin	कोचिन	कोचीन

kocheen	कोचिन	कोचीन

koteenchee	कोटींची	कोटींची

kotinchi	कोटींची	कोटींची

koteepeksha	कोटीपेक्षा	कोटीपेक्षा

kotipeksha	कोटिपकक्षा	कोटीपेक्षा

kothe	कोठे	कोठे

kothech	कोठेच	कोठेच

kothehee	कोठेही	कोठेही

konatahee	कोणतहही	कोणताही

kontahi	कोणताही	कोणताही

conark	कोनारकक	कोणार्क

konark	कोनारकक	कोणार्क

kothala	कोठला	कोथळा

koyaree	कोयाी	कोयरी

koyari	कोयरी	कोयरी

cooria	कोरिया	कोरिया

coorrea	कोर्या	कोरिया

corea	कोरिया	कोरिया

coria	कोरिया	कोरिया

corre	कोरे	कोरिया

correa	कोर्या	कोरिया

kooria	कोरीया	कोरिया

kooriya	कोरिया	कोरिया

korea	कोरिया	कोरिया

koria	कोरिया	कोरिया

koriya	कोरिया	कोरिया

qoria	कोरिया	कोरिया

qoriya	कोरिया	कोरिया

koreachya	कोरेयाच्या	कोरियाच्या

koriyachya	कोरियाच्या	कोरियाच्या

koreatil	कोरितातील	कोरियातील

koriyateel	कोरियातील	कोरियातील

koreane	कोरिनाने	कोरियाने

koriyane	कोरियाने	कोरियाने

kovale	कोवळे	कोवळे

kovle	कोवळे	कोवळे

kosh	कोश	कोष

kosabad	कोसबाद	कोसबाड

kosbad	कोसबडद	कोसबाड

kosalato	कोसळतो	कोसळतो

kaumudee	कौमुडी	कौमुदी

kaumudi	कौमुडी	कौमुदी

kram	क्रम	क्रम

kramaat	क्रमात	क्रमात

kramat	क्रमात	क्रमात

kreedangan	क्रेडेनग्	क्रीडांगण

kridangan	क्रीडनंगण	क्रीडांगण

kroorapana	क्रूरपण	क्रूरपणा

kroorpana	क्रूपपणा	क्रूरपणा

cras	क्रॉस	क्रॅश

crash	क्रॉश	क्रॅश

crashh	क्रशश	क्रॅश

crush	क्रुस	क्रॅश

kras	क्रॉस	क्रॅश

krash	क्रशश	क्रॅश

krashh	क्रशश	क्रॅश

kryash	क्राश	क्रॅश

qrash	क्रशश	क्रॅश

crage	क्राज	क्रेग

craig	क्रेग	क्रेग

creeg	क्रीग	क्रेग

creg	क्रीग	क्रेग

kreeg	क्रीग	क्रेग

kreg	क्रीग	क्रेग

qreg	क्रीग	क्रेग

kshatigrast	क्षििग्रस	क्षतिग्रस्त

kshatrap	क्षत्रप	क्षत्रप

kshtrap	क्ष््रप	क्षत्रप

kshatriy	क्षत्रिय	क्षत्रीय

kshatriya	क्षत्रिय	क्षत्रीय

kshamate	क्षमते	क्षमते

kshamatecha	क्षमतेचा	क्षमतेचा

kshamtecha	क्षमतेचा	क्षमतेचा

kshamateche	क्षमतेचे	क्षमतेचे

kshamteche	क्षमतेचे	क्षमतेचे

kshamatene	क्षमतेने	क्षमतेने

kshamatepeksha	क्षातेपेक्षा	क्षमतेपेक्षा

kshamatemule	क्षमतेमुळे	क्षमतेमुळे

kshamatela	क्षमतेला	क्षमतेला

kshamatevar	क्षमतेवर	क्षमतेवर

kshama	क्षमा	क्षमा

khandapeeth	खंडपीठ	खंडपीठ

khandpeeth	खंडपेठ	खंडपीठ

khandpith	खंडपीठ	खंडपीठ

khandojee	खंडोजी	खंडोजी

khandoji	खंडोजी	खंडोजी

khandoba	खंडोबा	खंडोबा

khandobach	खंडबबाच	खंडोबाचं

khandobacha	खंडबबाचा	खंडोबाचं

khandobachm	खंडबबाच	खंडोबाचं

khandobachya	खंबबबाच्या	खंडोबाच्या

khambeer	खाबीर	खंबीर

khambir	खाबीर	खंबीर

khatpat	खटपट	खटपट

khanijanche	खािजांचे	खनिजांचे

khanijanchya	खािजांच्या	खनिजांच्या

khanije	खािजे	खनिजे

kharade	खरडडे	खराडे

khalashani	खााशांनी	खलाशांनी

khalashanni	खााशांनी	खलाशांनी

khalashi	खाशशी	खलाशी

khalu	खाू	खलु

khandhyala	खांड्याला	खांद्याला

khandyala	खांड्याला	खांद्याला

khandhyavaril	खांड्यावरील	खांद्यावरील

khandyavareel	खानड्यावरील	खांद्यावरील

khandyavaril	खांड्यावरील	खांद्यावरील

khachet	खाचेत	खाचेत

khatyanchee	खतत्यांची	खात्यांची

khatyanchi	खतत्यांची	खात्यांची

khatyanche	खतत्यांचे	खात्यांचे

khatyanchya	खतत्यांच्या	खात्यांच्या

khatyakade	खतत्याकडे	खात्याकडे

khatyacha	खतत्याचा	खात्याचा

khatyache	खतत्याचे	खात्याचे

khatyat	खटत्यात	खात्यात

khatyane	खतत्याने	खात्याने

khatyamadhe	खटत्यामध्ये	खात्यामध्ये

khatyamadhye	खतट्यामध्ये	खात्यामध्ये

khadyapadarthat	खाद्यपदाराथात	खाद्यपदार्थात

khanvadi	खननवडी	खानवडी

khanwadi	खननवाी	खानवडी

khanaval	खाणववळ	खानावळ

kharafutee	खरराूटी	खारफुटी

kharfuti	खररफूटी	खारफुटी

khalavalelee	खालावलेली	खालावलेली

khalavaleli	खालावलेली	खालावलेली

khalavalelya	खालववलेल्या	खालावलेल्या

khalokhal	खालोहाल	खालोखाल

khalla	खाललला	खाल्ला

khallee	खाललली	खाल्ली

khalli	खाललली	खाल्ली

khasabag	खससबगग	खासबाग

khasbag	खासबगग	खासबाग

khasbhag	खससभगग	खासबाग

khiiladii	खिल्डी	खिलाडी

khiladi	खिलाडी	खिलाडी

qhiladi	खिलडडी	खिलाडी

khilkhile	खिललेले	खिळखिळे

khile	खिले	खिळे

khuntali	खुंटली	खुंटली

khoode	खुडे	खुडे

khude	खुडे	खुडे

khoop	खूप	खूप

khup	खूप	खूप

khoopach	खोपच	खूपच

khupach	खुपच	खूपच

khoti	खोती	खोटी

khote	खोते	खोटे

khot	खोट	खोत

khobanee	खोबणी	खोबणी

khobani	खोबणी	खोबणी

khobne	खोबणे	खोबणी

gangaram	गंगरराम	गंगाराम

gajendra	गाेंद्र	गजेंद्र

gadad	गडद	गडद

gadakhalee	गाखखाली	गडाखाली

gadakhali	गडखखाली	गडाखाली

ganachary	गणचचार्य	गणाचार्य

ganacharya	गणचचार्य	गणाचार्य

ganika	गािका	गणिका

gamavat	गमववत	गमावत

gamavalee	गमववली	गमावली

gamavali	गमववली	गमावली

gamavale	गाववले	गमावले

gamavle	गमववले	गमावले

gar	गर	गर

gur	गर	गर

garajeche	गरजेचे	गरजेचे

garjeche	गरजेचे	गरजेचे

garajetoon	गरजेतून	गरजेतून

garajetun	गरजेतून	गरजेतून

garajepeksha	गरजेपसक्षा	गरजेपेक्षा

garajepramane	गाजेप्रमाने	गरजेप्रमाणे

garachya	गराच्या	गराच्या

garat	गरतत	गरात

gartet	गाततेत	गर्तेत

gard	गा्ड	गर्द

gardee	गाडडी	गर्दी

gardi	गा्डी	गर्दी

gardeechee	गादडीची	गर्दीची

gardichi	गा्डीची	गर्दीची

gardiche	गाीडीचे	गर्दीचे

garditun	गा्डितून	गर्दीतून

gardimule	गादडिमुळे	गर्दीमुळे

gadre	गा्डे	गर्दे

garde	गा्डे	गर्दे

garbharapan	गर्भापपण	गर्भारपण

garbharpan	गर्भरपपण	गर्भारपण

garbharapanat	गर्भपपपणात	गर्भारपणात

garbharpanat	गर्भापपणात	गर्भारपणात

gavai	गाई	गवई

gavalan	गाळा	गवळण

gathave	गाठववे	गाठावे

gabharyat	गभभाऱ्यात	गाभाऱ्यात

galache	गाळचचे	गाळाचे

galat	गाळात	गाळात

galane	गाळणने	गाळाने

girija	गिरीजा	गिरिजा

gungala	गुंगला	गुंगला

gudgao	गुडगाव	गुडगाव

gudgav	गुडगाव	गुडगाव

gurakhee	गुरखखी	गुराखी

gurakhi	गुरखखी	गुराखी

gurunath	गुरूनाथ	गुरुनाथ

gure	गुरे	गुरे

gulchadi	गुलचाी	गुलछडी

gulchhadi	गुलचाी	गुलछडी

gulchhdee	गुलचडी	गुलछडी

gulab	गुलाब	गुलाब

gulabachee	गुलाबाची	गुलाबाची

gulabachi	गुलाबाची	गुलाबाची

gool	गोल	गूळ

gul	गुल	गूळ

gaesvar	गेसवर	गॅसवर

gasvar	गासवर	गॅसवर

gele	गेले	गेले

gelelya	गेलेल्या	गेलेल्या

gat	गाट	गॉट

got	गोट	गॉट

godrej	गोदरेज	गोदरेज

godee	गोडी	गोदी

godi	गोडी	गोदी

gopala	गोपाळ	गोपाला

goregaon	गोरेगाव	गोरेगाव

goregav	गोरगगाव	गोरेगाव

goleebarat	गोलीबररतत	गोळीबारात

golibarat	गोलीबररात	गोळीबारात

goleebaramule	गोलीबारुवुळे	गोळीबारामुळे

golibaramule	गोलीबारुवुळे	गोळीबारामुळे

govale	गोवळे	गोवले

govarikar	गोवररीकर	गोवारीकर

gowarikar	गोवररीकर	गोवारीकर

gaurav	गौरव	गौरव

gourav	गौरव	गौरव

grahanchee	ग्रहांची	ग्रहांची

grahanchi	ग्रहांची	ग्रहांची

grahanche	ग्रहांचे	ग्रहांचे

grahacha	ग्रहाचा	ग्रहाचा

grahachya	ग्रााच्या	ग्रहाच्या

grahat	ग्रहात	ग्रहात

grahala	ग्रााल	ग्रहाला

grahavar	ग्रहावर	ग्रहावर

greece	ग्रेक	ग्रीस

greececha	ग्रिकच	ग्रीसचा

greecechya	ग्रिके्या	ग्रीसच्या

greecene	ग्रेनेे	ग्रीसने

greecemadhye	ग्रेकमध्ये	ग्रीसमध्ये

greecevar	ग्रेकेर	ग्रीसवर

groopache	ग्रुपाे	ग्रूपचे

groupche	ग्रुपचे	ग्रूपचे

groth	ग्रोथ	ग्रोथ

growth	ग्रोव	ग्रोथ

gvalher	ग्वालरहरर	ग्वाल्हेर

gwalior	ग्वेलीयरर	ग्वाल्हेर

ghataprabha	घटसररभा	घटप्रभा

ghatprabha	घटप्रभा	घटप्रभा

ghatasthapana	घटस्थापना	घटस्थापना

ghatsthapna	घटस्थापना	घटस्थापना

ghadavate	घडवते	घडवते

ghadvate	घडवते	घडवते

gharabandhani	घरबंंधाी	घरबांधणी

gharabhandhanee	घराधधधाी	घरबांधणी

gharbandhani	घरबांधाी	घरबांधणी

ghasaralee	घसरली	घसरली

ghasarali	घररली	घसरली

ghasaroon	घारून	घसरून

ghasarun	घसरून	घसरून

ghagar	घागर	घागर

ghat	घाट	घात

ghatala	घातला	घातला

ghatla	घातला	घातला

ghaatlela	घातलेला	घातलेला

ghatalela	घातलेला	घातलेला

ghatlela	घातलेला	घातलेला

ghatalelya	घातलेल्या	घातलेल्या

ghatlelya	घातलेल्या	घातलेल्या

ghasatat	घससतात	घासतात

ghungaroo	घुंगुू	घुंगरू

ghungaru	घंंगाु	घुंगरू

ghubade	घुबदे	घुबडे

ghruneshwar	घृणेणेशावर	घृष्णेश्वर

ghrushneshvar	घृष्णेश्वर	घृष्णेश्वर

ghrushneshwar	घृष्णेश्वर	घृष्णेश्वर

ghoshana	घोषणा	घोषणा

chand	चंद	चंद

chanda	चंदााा	चंद

chandoo	चादू	चंदू

chandu	चंडू	चंदू

chakkee	चक्की	चक्की

chakki	चक्की	चक्की

chakr	चा्र	चक्र

chakra	चक्र	चक्र

chaqra	चक्र	चक्र

chakram	चक्रम	चक्रम

chakravartee	चकररााीथी	चक्रवर्ती

chakravarti	चकरराा्ती	चक्रवर्ती

chakravarutee	चक्राृीती	चक्रवर्ती

chakravyooh	चा्रव्यहह	चक्रव्यूह

chakravyuh	चक्रवियूह	चक्रव्यूह

chakrvyooh	चा्रव्याह	चक्रव्यूह

chakrakar	चा्रककार	चक्राकार

chakrache	चक्राचे	चक्राचे

chakrat	चकररात	चक्रात

chakree	चा्री	चक्री

chakri	चा्री	चक्री

chakreey	चक्रीय	चक्रीय

chakriy	चक्रिय	चक्रीय

chadh	चढ	चढ

chadhala	चढला	चढला

chadhali	चढली	चढली

chadhale	चढले	चढले

chadhavane	चढवाे	चढवणे

chadhavne	चढवणे	चढवणे

chadhavat	चढवत	चढवत

chadhvat	चढवत	चढवत

chadhavala	चढवला	चढवला

chanchan	चाचन	चणचण

chaturthat	चतुरथथात	चतुर्थात

chamatkar	चमतककरर	चमत्कार

chamtkar	चमकककरर	चमत्कार

chamatkarachi	चमतककरराची	चमत्काराची

chamtkarachi	चमक्करराची	चमत्काराची

chamatkarik	चमतककारकक	चमत्कारिक

chamtkarik	चमकककररिक	चमत्कारिक

chalanvadh	चाववधध	चलनवाढ

changala	चांगला	चांगला

changla	चांगला	चांगला

changalach	चंंगलचच	चांगलाच

changlach	चांगळचच	चांगलाच

chandee	चांदी	चांदी

chandi	चांदी	चांदी

chandeechya	चांदीच्या	चांदीच्या

chandichya	चांदीच्या	चांदीच्या

chandeene	चांदीने	चांदीने

chandine	चांदीने	चांदीने

chandoli	चांदोली	चांदोली

chambhar	चेंभरर	चांभार

chaturmasaat	चततूरममासात	चातुर्मासात

chaturmasat	चौतूरममासात	चातुर्मासात

charles	चार्लसस	चार्ल्स

charls	चार्ल्स	चार्ल्स

charlsa	चार्लसस	चार्ल्स

chaloo	चालू	चालूं

chaloon	चालूनन	चालूं

chalu	चालू	चालूं

cheenchvad	चिचचाा	चिंचवड

cheenchwad	चिचचाड	चिंचवड

chiinchwad	चिचचाा	चिंचवड

chinchavad	चिचचाा	चिंचवड

chinchawad	चिचचाा	चिंचवड

chinchvad	चिचचाा	चिंचवड

chinchwad	चिचचाा	चिंचवड

chikat	चिकत	चिकट

chakata	चककता	चिकटा

chikta	चिकता	चिकटा

chikatun	चिकटून	चिकटून

chikatuun	चिकटून	चिकटून

chikati	चिकटती	चिकाटी

chitrapatasrushti	चित्रपटस्ष्टी	चित्रपटसृष्टी

chitrapatsrushti	चित्रपटस्ष्टी	चित्रपटसृष्टी

chitrapatasrushtichya	चित्रपटसृष्टीच्या	चित्रपटसृष्टीच्या

chitrapatsrushtichya	चित्रपटसृष्टीच्या	चित्रपटसृष्टीच्या

chitrapatasrushtitil	चित्रपटसृतिटीलील	चित्रपटसृष्टीतील

chitrapatsrushtitil	चित्रपटशृषिटीलोल	चित्रपटसृष्टीतील

chitrapatasrushtiwar	चित्रपटशृष्टावक	चित्रपटसृष्टीवर

chitrapatsrushtivar	चित्रपटिृष्टाव	चित्रपटसृष्टीवर

chitrapatsrushtiwar	चित्रपटशृष्टीवर	चित्रपटसृष्टीवर

chitrafeet	चित्रफित	चित्रफीत

chitrafit	चित्रफित	चित्रफीत

chitraphit	चित्रफित	चित्रफीत

cheenar	चीनरर	चिनार

chinar	चीनरर	चिनार

cheeni	चीनी	चिनी

chini	चिनी	चिनी

cheap	चिप	चिप

cheep	चीप	चिप

chip	चिप	चिप

cheepalunkar	चिपळककका	चिपळूणकर

chipalunkar	चिपळककका	चिपळूणकर

chiplunkar	चिपळणककर	चिपळूणकर

chilkhat	चिलखा	चिलखत

cheelam	चिलमम	चिलीम

chilam	चिलमम	चिलीम

chilim	चिलीम	चिलीम

chile	चिले	चिले

chee	ची	ची

chi	ची	ची

chii	ची	ची

cheese	चिसस	चीज

chij	चीज	चीज

cheesevastoo	सिससस्को	चीजवस्तू

cheesevastu	चिससस्को	चीजवस्तू

chijvastoo	चिजवस्तू	चीजवस्तू

chijvastu	चिजवस्तू	चीजवस्तू

chukata	चुकता	चुकता

chukta	चुकता	चुकता

chukali	चुकली	चुकली

chukli	चुकली	चुकली

chukavoon	चुकवून	चुकवून

chukavun	चुकवून	चुकवून

chukvun	चुकवून	चुकवून

chuka	चुका	चुका

championship	चमम्पिसो्	चॅम्पियनशिप

cheladee	चेळडडी	चेलाडी

cheladi	चेळाडी	चेलाडी

cheshta	चेस्ट	चेष्टा

cheshtaa	चेषतटा	चेष्टा

chauki	चौकी	चौकी

chowki	चौकी	चौकी

chaukeevar	चौकीवर	चौकीवर

chaukivar	चौकीवर	चौकीवर

chowkivar	चौकीवर	चौकीवर

chauras	चौरा	चौरस

chouras	चौरा	चौरस

chata	छता	छटा

chhata	छता	छटा

jagan	जगन	जगणं

jaganm	जगमम	जगणं

jagn	जगं	जगणं

jaganyachee	जाण्याची	जगण्याची

jaganyachi	जगण्याची	जगण्याची

jagnyachi	जगण्याची	जगण्याची

jaganyaat	जगण्यात	जगण्यात

jaganyat	जाण्यात	जगण्यात

jagnyat	जगण्यात	जगण्यात

jaganyapeksha	जाण्यापेक्षा	जगण्यापेक्षा

jagnyapeksha	जजण्यापेक्षा	जगण्यापेक्षा

jaganyashee	जगण्याशी	जगण्याशी

jaganyashi	जगण्याशी	जगण्याशी

jagnyashi	जगण्याशी	जगण्याशी

jadangadanivar	जाणगडाीदर	जडणघडणीवर

jadanghadanivar	जडणघडणीवर	जडणघडणीवर

jadanghadnivar	जडणगडवीवर	जडणघडणीवर

janamanasant	जनमानं्तत	जनमानसांत

janmaansaant	जन्ांाांत	जनमानसांत

janmansant	जन्ांस्तत	जनमानसांत

janamanasavar	जनमानसावर	जनमानसावर

janmaansaavar	जन्ाससावर	जनमानसावर

janmansavar	जन्ाससावर	जनमानसावर

janaavranchi	जाावरांची	जनावरांची

janavaranchi	जाावरांची	जनावरांची

janawaranchi	जाावरांची	जनावरांची

janaavranchya	जाावरांच्या	जनावरांच्या

janavaranchya	जाावरांच्या	जनावरांच्या

janawaranchya	जाावरांच्या	जनावरांच्या

janaavransaathi	जाावर्ंसाठी	जनावरांसाठी

janavaransathi	जाावर्ंसाठी	जनावरांसाठी

janawaransathi	जाावर्ंसाठी	जनावरांसाठी

janaavrachya	जाावरचच्या	जनावराच्या

janavarachya	जाावराच्या	जनावराच्या

janawarachya	जाावरचच्या	जनावराच्या

janaavras	जाावरास	जनावरास

janavaras	जाावरास	जनावरास

janawaras	जाावरसस	जनावरास

jabbar	जबबबरर	जब्बार

jamne	जमने	जमणे

jamat	जमा	जमत

jamataat	जमतात	जमतात

jamtaat	जमतात	जमतात

jamtat	जमतात	जमतात

janmtat	जनण्त	जमतात

jamanaalaal	जमनललाल	जमनालाल

jamnalal	जमनलला	जमनालाल

jameenitach	जमिनीतच	जमिनीतच

jamineetach	जमिनीतच	जमिनीतच

jaminitach	जमिनीचच	जमिनीतच

jayraj	जयराज	जयराज

jard	जर्ड	जर्द

jalvidhyoot	जाविध्योत	जलविद्युत

jalvidhyut	जवविध्युत	जलविद्युत

jalvidyut	जाविद्यात	जलविद्युत

jalwidhyoot	जाविध्योत	जलविद्युत

jalwidyut	जाविद्योत	जलविद्युत

jalajal	जळाल	जळजळ

jaljal	जळजल	जळजळ

jalatana	जलताना	जळताना

jaltana	जलताना	जळताना

javalakar	जवळकर	जवळकर

javalkar	जवळकर	जवळकर

jawalkar	जवळकर	जवळकर

jast	जा्त	जस्त

jahangeer	जहांगीर	जहांगिर

jahangir	जहांगीर	जहांगिर

jaagarukata	जागरूकता	जागरुकता

jaagrukta	जागरूक्ा	जागरुकता

jagrukta	जागरूकता	जागरुकता

jaagaa	जगगा	जागा

jaga	जागा	जागा

jaageech	जागीच	जागीच

jaagich	जागीच	जागीच

jagich	जागीच	जागीच

jaaniva	जाणिवा	जाणीवा

jaaniwa	जाणिवा	जाणीवा

janiva	जाणिवा	जाणीवा

jaatanya	जातान	जातंय

jaatay	जाता	जातंय

jatanya	जाताया	जातंय

jatay	जाते	जातंय

jaatichi	जातीची	जातीची

jatichi	जातीची	जातीची

jaatey	जाते	जातेय

jatey	जेते	जातेय

jaadoogar	जादुग्	जादूगर

jaadugar	जादुगर	जादूगर

jadugar	जादुगर	जादूगर

jaaliyanvala	जाळिंाालला	जालियनवाला

jaaliyanwala	जाळिंाालला	जालियनवाला

jaliyanvala	जाळिनाालला	जालियनवाला

jallianwala	जललींाालला	जालियनवाला

jasteecha	जास्तीचा	जास्तीचा

jasticha	जास्तीचा	जास्तीचा

jijaabaainnaa	जिजाबाईंना	जिजाबाईंना

jijabainna	जिजाबीईंना	जिजाबाईंना

jirnoddhar	जीर्णोद्धार	जिर्णोद्धार

jirnodhdaar	जीर्णोद्धार	जिर्णोद्धार

jeevandan	जीवनदनन	जीवनदान

jivandaan	जीवनदान	जीवनदान

jiwandaan	जीवनदान	जीवनदान

jaan	जाणन	जुआन

jooan	जूनन	जुआन

juaan	जुनन	जुआन

juan	जुनन	जुआन

zooan	जूनन	जुआन

zuan	जूनन	जुआन

julaimadhye	जुळीमध्ये	जुलैमध्ये

julymadhye	जुल्मध्ये	जुलैमध्ये

jethe	जेथ	जेथे

jeefree	जिफ्री	जेफ्री

jeefreey	जेफ्रीय	जेफ्री

jeephri	जिफररी	जेफ्री

jeffree	जेफ्फफ	जेफ्री

jeffrey	जेफ्फफ	जेफ्री

jeffri	जेफ्फी	जेफ्री

jefree	जेफ्री	जेफ्री

jefrei	जेफ्री	जेफ्री

jefrey	जेफ्रे	जेफ्री

jefri	जेफ्री	जेफ्री

jefrii	जेर्री	जेफ्री

jephree	जेफ्री	जेफ्री

jephrey	जेफररे	जेफ्री

jephri	जेफररी	जेफ्री

jephrii	जेफ्री	जेफ्री

zefree	झेफ्री	जेफ्री

zefrey	झेफ्री	जेफ्री

zephri	झेहररी	जेफ्री

jevadhee	जेवधी	जेवढी

jevadhi	जेवधी	जेवढी

jevdhee	जेवढी	जेवढी

jevdhi	जेवढी	जेवढी

jain	जयन	जैन

jaina	जयन	जैन

jan	जनन	जैन

jen	जेन	जैन

jena	जेनााा	जैन

zain	जेन	जैन

zaina	जयन	जैन

zan	जॉन	जैन

jainaanche	जयनांचे	जैनांचे

jainanche	जैनांचे	जैनांचे

jac	जॅक	जॉक

jack	जॅक	जॉक

jak	जॅक	जॉक

jaq	जॅक	जॉक

joc	जॅक	जॉक

jock	जॅक	जॉक

jocq	जॅक	जॉक

jok	जोक	जॉक

joq	जोक	जॉक

jyak	ज्क	जॉक

jyok	ज्क	जॉक

jyoq	ज्क	जॉक

zak	झॅक	जॉक

zoc	जोक	जॉक

zock	जोक	जॉक

zok	जोक	जॉक

zyok	झ्य	जॉक

jo	जो	जो

joe	जो	जो

joo	जू	जो

jooe	जू	जो

zoe	जो	जो

jodgolee	जोडगोली	जोडगोळी

jodgoli	जोडगोली	जोडगोळी

jodagoleecha	जोडगालीचा	जोडगोळीचा

jodagolicha	जोडगोलीचा	जोडगोळीचा

jodagolichaa	जोडगोलीचा	जोडगोळीचा

jodgoleecha	जोडगोलीचा	जोडगोळीचा

jodgolicha	जोडगोलीचा	जोडगोळीचा

jodgolichaa	जोडगोलीला	जोडगोळीचा

jodgolichya	जोगगोलीच्	जोडगोळीचा

jodagoleene	जोडगलली	जोडगोळीने

jodagoline	जोडगोली	जोडगोळीने

jodgoleene	जोडगलली	जोडगोळीने

jodgoline	जोडगोली	जोडगोळीने

joparyant	जोपर्यंत	जोपर्यंत

joparyanta	जोपर्यंत	जोपर्यंत

jolee	जोळी	जोली

joli	जोळी	जोली

jolii	जोळी	जोली

jolly	जोली	जोली

joly	जोळी	जोली

joolee	जोळी	जोली

jooli	जोळी	जोली

joolly	जुली	जोली

zolee	जोळी	जोली

zoli	जोळी	जोली

zolly	झोली	जोली

jyada	ज्याद	ज्यादा

jyadaa	ज्यादा	ज्यादा

jhalakat	झाकट	झळकत

jhalhkat	झाकट	झळकत

zalakat	झाकट	झळकत

jhaabooa	झाबू	झाबुआ

jhaabua	झाबू	झाबुआ

jhabooa	झाबू	झाबुआ

jhabua	झाबू	झाबुआ

jhabuaa	झाऊू	झाबुआ

zaabooa	जाबू	झाबुआ

zaabua	जाबू	झाबुआ

zabua	झाबू	झाबुआ

zabuaa	जाबू	झाबुआ

jarakhanda	जररांड	झारखंड

jaraqhanda	जररांड	झारखंड

jharkhand	झररखंड	झारखंड

jharkhanda	झररखाडा	झारखंड

jharqhand	झररखाड	झारखंड

zarakhanda	झररााड	झारखंड

zharkhand	झररखंड	झारखंड

zharqhand	झररखाड	झारखंड

jharkhandachya	झररखाडा्या	झारखंडच्या

jharkhandchya	झररखाडच्या	झारखंडच्या

jharkhandchyaa	झररखाडच्या	झारखंडच्या

jhaalyanantar	झाल्यानंतर	झाल्यानंतर

jhalyanantar	झाल्यानंतर	झाल्यानंतर

zaalyanantar	झाल्यानंतर	झाल्यानंतर

zalyaanantar	झाल्यानंतर	झाल्यानंतर

zalyanantar	झाल्यानंतर	झाल्यानंतर

jhalyanantarhi	झाल्यानंतरही	झाल्यानंतरही

zalyanantarahi	झाल्यानंतरही	झाल्यानंतरही

jee	जी	झी

jhi	जी	झी

ji	जी	झी

jii	जी	झी

zee	जी	झी

zi	जी	झी

zii	जी	झी

zero	जेरो	झीरो

jhunj	झुंज	झुंज

zunj	जुंज	झुंज

zunja	झुंजााा	झुंज

jhunjee	झुंजी	झुंजी

jhunji	झुंजी	झुंजी

zunji	झुंजी	झुंजी

jhudapaat	झुडपाट	झुडपात

jhudapat	झुडपात	झुडपात

jhudpat	झुडपात	झुडपात

zudapaat	झुडपात	झुडपात

zudapat	झुपपटत	झुडपात

jhudapi	झुडाी	झुडपी

jhudpi	झुडपी	झुडपी

zudapi	झुडाी	झुडपी

jhuloo	झुलू	झुलू

jhulu	झुलू	झुलू

joolu	जुलू	झुलू

julu	जुल	झुलू

juuluu	जुलू	झुलू

zaalu	झाला	झुलू

zoolu	जुल	झुलू

zooluu	जुळू	झुलू

zuloo	जुलू	झुलू

zulu	जुल	झुलू

zuulu	जुलू	झुलू

zuuluu	जुलू	झुलू

zonal	जोनल	झोनल

zonela	जोनेे	झोनल

zopadapatti	झोपापतीटी	झोपडपट्टी

zopadpatti	झोपापतीटी	झोपडपट्टी

zopadpattitil	झोपापतीटीत	झोपडपट्टीतील

jhoya	झोया	झोया

zoya	जोया	झोया

tandon	ताडू	टंडन

takkal	टक्कल	टक्कल

takkyanni	टा्य्यांनी	टक्क्यांनी

taratara	तातरर	टराटरा

taanksal	टाकक्ाळ	टांकसाळ

tanksal	टांकलाळ	टांकसाळ

tanksalh	टांकलाह	टांकसाळ

taaknare	टाकणारे	टाकणारे

takanare	टाकणारे	टाकणारे

taknare	टाकणारे	टाकणारे

taakte	टाकते	टाकते

takate	टाकते	टाकते

takete	टाकेे	टाकते

takte	टककते	टाकते

taft	टॉफटट	टाफ्ट

tafta	ताफटट	टाफ्ट

tapht	तफफ	टाफ्ट

taphta	तफफ्ट	टाफ्ट

talane	ताळणे	टाळणे

talhne	टाळणे	टाळणे

talhta	टाळता	टाळता

talta	टाळता	टाळता

talali	तळलली	टाळली

talhli	तळळली	टाळली

talhun	टाळून	टाळून

taloon	ताळून	टाळून

talun	ताळून	टाळून

tikato	टिकतो	टिकतो

tikto	टिक्ो	टिकतो

takavta	टाकाता	टिकवता

tikavata	टिकाता	टिकवता

tikawata	टिकाता	टिकवता

tikvata	टिक्ता	टिकवता

tikavli	टिकाली	टिकवली

tikawali	टिकाली	टिकवली

tikvali	टिकलली	टिकवली

tipoochya	तिपोच्या	टिपूच्या

tipuchya	तिपूच्या	टिपूच्या

tipuchyaa	तिपूच्या	टिपूच्या

tika	टिक	टीका

tiip	तीप	टीप

tiipa	टिप	टीप

tip	टीप	टीप

tipa	टिप	टीप

taiiksee	टाक्सी	टॅक्सी

taiiksii	टाक्सी	टॅक्सी

taiixii	ताकीसी	टॅक्सी

taiksee	टेक्सी	टॅक्सी

taikshee	टेक्स	टॅक्सी

taikshi	टेक्स	टॅक्सी

taiksi	टेकीसी	टॅक्सी

taiksii	टेक्सी	टॅक्सी

taiqsee	टेक्सी	टॅक्सी

taiqsi	टेकीसी	टॅक्सी

taixi	टेक्सी	टॅक्सी

takshi	टाक्सी	टॅक्सी

taksi	टाकीसी	टॅक्सी

taksii	टाक्सी	टॅक्सी

taqsi	टाक्सी	टॅक्सी

taxi	टाकीस	टॅक्सी

taxii	ताक्सी	टॅक्सी

teksee	टेक्स	टॅक्सी

teksi	टेक्सी	टॅक्सी

texi	टेक्सी	टॅक्सी

tabaleet	तबबेीत	टॅबलेट

tabalet	ताबलेत	टॅबलेट

tableet	तेबलीट	टॅबलेट

tablet	तेबे	टॅबलेट

tembhurni	टेंभरर्मी	टेंभुर्णी

tenbhurnee	टेंभरर्णी	टेंभुर्णी

tenbhurni	टेंभरर्जी	टेंभुर्णी

tenmurni	टेनरररीमी	टेंभुर्णी

tari	तररी	टेरी

tarrie	तररी	टेरी

tarry	तररी	टेरी

teeri	तेरी	टेरी

teerriee	तेरी	टेरी

teerry	तेरी	टेरी

teri	तेरी	टेरी

terie	तेरी	टेरी

terii	तेरी	टेरी

terrie	तेरी	टेरी

terriie	तेरी	टेरी

terry	टेरी	टेरी

tery	तेरी	टेरी

taresa	तररेसा	टेरेसा

teereesa	तेरेस	टेरेसा

teeyreesa	तेरेसा	टेरेसा

teresa	तेरेसा	टेरेसा

teyresa	तेरेस	टेरेसा

tail	तेल	टेल

tale	ताल	टेल

tel	तेल	टेल

tell	तेल	टेल

topalee	टोपली	टोपली

topali	टोपाी	टोपली

topli	टोपली	टोपली

topalya	तोळा्या	टोपल्या

toplya	टोळल्या	टोपल्या

tope	टोप	टोपे

topya	टोप्या	टोप्या

tofu	तोफ	टोफू

tofuu	तोफ	टोफू

toofu	तोफ	टोफू

toophu	तोफ	टोफू

tophu	टोफ	टोफू

tophuu	तोफ	टोफू

tola	तोल	टोला

tole	टोळे	टोले

trackchya	ट्रक््या	ट्रकच्या

trakchya	ट्रका्या	ट्रकच्या

truckchya	त्रुू्या	ट्रकच्या

trackavar	ट्रॉार	ट्रकवर

trakavar	ट्रेार	ट्रकवर

truckvar	ट्रुुर्	ट्रकवर

truckwar	ट्रुुर	ट्रकवर

traks	ट्रॉ्स	ट्रक्स

traqs	ट्रॉ्स	ट्रक्स

trucks	ट्रॉ्स	ट्रक्स

trucqs	ट्रॉ्स	ट्रक्स

trackin	ट्रेकिंग	ट्रॅकिंग

tracking	ट्रेकिंग	ट्रॅकिंग

tracqing	ट्रेकिंग	ट्रॅकिंग

trakin	ट्रेकिंग	ट्रॅकिंग

traking	ट्रेकिंग	ट्रॅकिंग

traqing	ट्रेकिंग	ट्रॅकिंग

traceey	त्रेची	ट्रेसी

tracei	ट्रेस	ट्रेसी

tracey	ट्रेक	ट्रेसी

traci	ट्रेस	ट्रेसी

tracy	ट्रे	ट्रेसी

traiisii	ट्रेसी	ट्रेसी

traisi	ट्रेसी	ट्रेसी

treci	ट्रेक	ट्रेसी

trecy	ट्रीकी	ट्रेसी

treecy	ट्रीकी	ट्रेसी

treesi	ट्रेसी	ट्रेसी

treesy	ट्रेसी	ट्रेसी

tresi	ट्रेसी	ट्रेसी

tresii	ट्रेसी	ट्रेसी

tresy	ट्रेस	ट्रेसी

tvitar	ट्वीटर	ट्विटर

tvittar	टिटितर	ट्विटर

tvitter	ट्टिटर	ट्विटर

twitar	ट्टीटर	ट्विटर

twitara	ट्टीटर	ट्विटर

twittar	टीटितर	ट्विटर

twitter	टिटितर	ट्विटर

twittervar	ट्टिट््र	ट्विटरवर

tharali	ठरली	ठरली

tharli	ठरली	ठरली

tharavile	ठरविले	ठरविले

tharvile	ठरविले	ठरविले

tharavilelya	ठरविलेल्या	ठरविलेल्या

tharvilelya	ठरविलेल्या	ठरविलेल्या

tharavet	ठरववेत	ठरावेत

thushi	ठुशी	ठुशी

thevanyacha	ठेवण्याचा	ठेवण्याचा

thevnyacha	ठेवण्याचा	ठेवण्याचा

thewanyacha	ठेवण्याचा	ठेवण्याचा

thevanyachee	ठेवण्याची	ठेवण्याची

thevnyachi	ठेवण्याची	ठेवण्याची

thewanyachi	ठेवण्याची	ठेवण्याची

thevanyache	ठेवण्याचे	ठेवण्याचे

thevnyache	ठेवण्याचे	ठेवण्याचे

thewanyache	ठेवण्याचे	ठेवण्याचे

thevanyane	ठेवण्याने	ठेवण्याने

thewanyane	ठेवण्याने	ठेवण्याने

thevanyas	ठेवण्यास	ठेवण्यास

thewanyas	ठेवण्यास	ठेवण्यास

thevanyasathee	ठेवण्यासाठी	ठेवण्यासाठी

thevnyasathi	ठेवण्यासाठी	ठेवण्यासाठी

thewanyasathi	ठेवण्यासाठी	ठेवण्यासाठी

dalees	देिस	डलेस

dales	दॅेस	डलेस

dules	दुेश	डलेस

dullees	दु्क	डलेस

dulles	दु्ल	डलेस

daakghar	दाघघर	डाकघर

dakaghar	दकखघर	डाकघर

dakghar	दाखघर	डाकघर

dalhimb	दाह्ंब	डाळिंब

dalimb	दालिंब	डाळिंब

dalimba	दालिंबा	डाळिंब

dalinb	दाळींब	डाळिंब

dalhimbacha	दाहिंबाचा	डाळिंबाचा

dalimbacha	दालींबचचा	डाळिंबाचा

davapech	दावाेच	डावपेच

davpech	डावेेच	डावपेच

dawpech	दावेेच	डावपेच

davapechanchi	दावेेचनंची	डावपेचांची

davpechanchi	दावेेचांची	डावपेचांची

depressed	देप्रेसदद	डिप्रेस्ड

dipresd	दिप्रसस	डिप्रेस्ड

decembermadhye	डेक्मबरमधीये	डिसेंबरमध्ये

decemberat	डेकेमबर	डिसेंबरात

deental	देंटल	डेंटल

dental	देंटल	डेंटल

dalbee	दाल्बे	डॉल्बी

dalbi	दाल्बी	डॉल्बी

dalbii	दबल्बी	डॉल्बी

dalby	डालीबी	डॉल्बी

dolbee	डोलबबी	डॉल्बी

dolbii	डॉल्बी	डॉल्बी

dolby	डोलीबी	डॉल्बी

dongararanga	डोंगररांगा	डोंगररांगा

dongarranga	डोंगररांगा	डोंगररांगा

dongararanganni	डोगगररांगांनी	डोंगररांगांनी

dongarranganni	डोंगररांगांनी	डोंगररांगांनी

dohee	दोही	डोही

dohi	दोही	डोही

dram	द्रा	ड्रम

drum	द्रु	ड्रम

drummadhye	द्रुुध्ये	ड्रममध्ये

dhagaal	ढगळल	ढगाळ

dhagal	ढगळल	ढगाळ

dhagalh	ढगाल	ढगाळ

dhanya	धाण्या	ढाण्या

dhasalhun	ढससळून	ढासळून

dhasalun	ढससळून	ढासळून

dhasloon	धससळून	ढासळून

tantradnyanacha	तंत्रज्ञानाचा	तंत्रज्ञानाचा

tantragyanacha	तंत्रज्ञाचाचा	तंत्रज्ञानाचा

tantradnyanachee	तंत्रज्ञांाची	तंत्रज्ञानाची

tantradnyanachi	तंत्रज्ञानाची	तंत्रज्ञानाची

tantragyanachee	तंत्रज्ञाचचची	तंत्रज्ञानाची

tantragyanachi	तंत्रज्ञाचाची	तंत्रज्ञानाची

tantradnyanache	तंत्रज्ञानाची	तंत्रज्ञानाचे

tantragyanache	तंत्रज्ञाचचची	तंत्रज्ञानाचे

tantradnyanateel	तंत्रज्ञानातील	तंत्रज्ञानातील

tantradnyanatil	तंत्रज्ञानातील	तंत्रज्ञानातील

tantragyanateel	तंत्रज्ञानातील	तंत्रज्ञानातील

tantragyanatil	तंत्रज्ञातातील	तंत्रज्ञानातील

tantradnyanavar	तंत्रज्ञानावर	तंत्रज्ञानावर

tantragyanavar	तंत्रज्ञानावर	तंत्रज्ञानावर

tantradnyane	तंत्रज्ञाने	तंत्रज्ञाने

tantragyane	तंत्रज्ञाने	तंत्रज्ञाने

tadnyanche	ता्ञांची	तज्ञांचे

tagyanche	ता्ञाचचे	तज्ञांचे

tadaka	ताक	तडका

tadka	टडका	तडका

tadakafadakee	तडकादाीी	तडकाफडकी

tadkafadki	तडााळडीी	तडकाफडकी

tat	तट	तत्

tet	ते	तत्

tut	तू	तत्

tatkaleek	तत्कालीक	तत्कालिक

tatkalik	तत्कालिक	तत्कालिक

tatkaleen	तत्कालीन	तत्कालिन

tatkalin	तत्कालीन	तत्कालिन

tadanantar	तााातर	तदनंतर

tadnantar	तानातर	तदनंतर

tapt	टप्त	तप्त

tapta	टा्ता	तप्त

tabakadi	ताकाी	तबकडी

tabkadee	ता्डी	तबकडी

tabkadi	तब्डी	तबकडी

tabalaji	तबलाी	तबलजी

tabalji	तबलजी	तबलजी

tablaji	तेलाी	तबलजी

tamanna	तााान	तमन्ना

tamannaa	ताााना	तमन्ना

taranee	ताणी	तरणी

tarani	तरणी	तरणी

taruninsathi	तरुनींसाठी	तरुणींसाठी

tarjanee	तर्जनी	तर्जनी

tarjani	तर्जनी	तर्जनी

tarjni	तर्जनी	तर्जनी

talaghar	तळघर	तळघर

talghar	तळघर	तळघर

talavaroon	तळावरून	तळावरून

talavarun	तलावरून	तळावरून

talawarun	ताावरून	तळावरून

talee	तळी	तळी

tali	तळी	तळी

taloon	तळून	तळून

talun	ताून	तळून

talyacha	तळ्याचा	तळ्याचा

talyachya	तळ्याच्या	तळ्याच्या

talyavar	तल्यावर	तळ्यावर

tase	तेे	तसे

tasehi	ताेही	तसेही

tandulaja	तांदुळाा	तांदुळजा

tambera	तांबेर	तांबेरा

taag	ताग	ताग

tag	तगग	ताग

taja	तजज	ताजा

tajya	ताज्या	ताज्या

taatkal	तातककाल	तात्काळ

tatkal	तततककाल	तात्काळ

taneeya	ताणेया	तानिया

tania	ताणिया	तानिया

taniiya	तानिया	तानिया

taniya	ताणिया	तानिया

taapmaan	तापमान	तापमान

tapaman	तपपमान	तापमान

tapman	तापमान	तापमान

taapmanachya	तापमननाच्या	तापमानाच्या

tapamanachya	तपपमानाच्या	तापमानाच्या

tapmanachya	तापमानाच्या	तापमानाच्या

taapmanat	तापमानात	तापमानात

tapamanat	तपपमननात	तापमानात

tapmanat	तापमानात	तापमानात

taapmanapeksha	तापनननकसेक्षा	तापमानापेक्षा

tapamanapeksha	तपपाननेपेक्षा	तापमानापेक्षा

taapmaanamule	तापमानामुळे	तापमानामुळे

tapamanamule	तापमननामुळे	तापमानामुळे

taapamanavar	तापाानावर	तापमानावर

tapamanavar	तपपमानावर	तापमानावर

tapmanavar	तपपमानावर	तापमानावर

talibaan	तालिबान	तालिबान

taliban	तळलिबान	तालिबान

talibana	तळळिबान	तालिबान

talyban	तळळ्जाण	तालिबान

talibanachya	तळलिबाना्या	तालिबानच्या

talibanchya	तालिबांच्या	तालिबानच्या

talibanane	तालिबांने	तालिबानने

talibanne	ताळिबांेे	तालिबानने

taasa	तासा	ताशा

taasha	तशसा	ताशा

taashha	तशशा	ताशा

tasa	तससा	ताशा

tasha	तशशा	ताशा

tashha	तशशा	ताशा

tichyasah	तिच्यास	तिच्यासह

tichyasaha	तिच्यासा	तिच्यासह

tithehi	तिथेही	तिथेही

tibarius	तिबारिसा	तिबेरियस

tibariyas	तिबारिया	तिबेरियस

tibeerius	ताबिरीसस	तिबेरियस

tibeeriyas	ताबिरिया	तिबेरियस

tiberius	ताबररिस	तिबेरियस

tiberiyas	ताबेरियस	तिबेरियस

teenda	तींदा	तीनदा

tinada	तिनदा	तीनदा

teelache	तिलचचे	तीळाचे

tilache	तिलचचे	तीळाचे

teeshun	तिशूून	तीसहून

tisahun	तिसहून	तीसहून

tishun	तिशूून	तीसहून

taang	तांग	तुंग

toong	तुंग	तुंग

tung	तुंग	तुंग

toongi	टुंगी	तुंगी

tungee	तुंगी	तुंगी

tungi	तुंगी	तुंगी

tookadicha	तुकडीचा	तुकडीचा

tukadeecha	तुकदीचा	तुकडीचा

tukadicha	तुकदीचा	तुकडीचा

tukadichaa	तुकदीचा	तुकडीचा

tookadiche	तुकडीचे	तुकडीचे

tukadeeche	तुकडीचे	तुकडीचे

tukadiche	तुकडीचे	तुकडीचे

tukdiche	तुकडीचे	तुकडीचे

tookadine	तुकडीने	तुकडीने

tukadeene	तुकडीने	तुकडीने

tukadine	तुकडीने	तुकडीने

tukdine	तुकदीने	तुकडीने

tookadila	तुकडीला	तुकडीला

tukadeela	तुकडीला	तुकडीला

tukadila	तुकडीला	तुकडीला

tukadilaa	तुकडीला	तुकडीला

tukdila	तुकडीला	तुकडीला

tukadoji	तुकाोजी	तुकडोजी

tukdoji	तुकोोजी	तुकडोजी

tujhee	तुझी	तुझी

tujhi	तुझी	तुझी

tuzee	तुझी	तुझी

tuzi	तुझी	तुझी

tumachya	तुमच्या	तुमच्या

tumchya	तुमच्या	तुमच्या

toorichya	तोरीच्या	तुरीच्या

tureechya	तुरीच्या	तुरीच्या

turichya	तुरीच्या	तुरीच्या

turichyaa	तुरीच्या	तुरीच्या

turoongat	तुरंंगात	तुरूंगात

turungaat	तुरुंगात	तुरूंगात

turungat	तुरुंगात	तुरूंगात

toolanatmak	तुलनातकमक	तुलनात्मक

tulanaatmak	तुलनात्मक	तुलनात्मक

tulanatmak	तुलनातकमक	तुलनात्मक

tulnatmak	तुलनात्मक	तुलनात्मक

toopacha	तोपचचा	तूपाचा

tupacha	तुपचचा	तूपाचा

tendulkar	तेंदुळ्र	तेंडुलकर

tendulkaranchi	तेंदुळकाांची	तेंडुलकरांची

tendulkaranche	तेंदुळकाांचे	तेंडुलकरांचे

tethale	तेथले	तेथले

tethle	तेथले	तेथले

tethvar	तेथरर	तेथवर

teravya	तेराव्या	तेराव्या

teravyaa	तेराव्या	तेराव्या

terawya	तेराव्या	तेराव्या

telatumbade	तेताुंबेे	तेलतुंबडे

teltumbade	टेलुुजबेे	तेलतुंबडे

teltumbde	टेलगुजबेे	तेलतुंबडे

tevadham	तेवढा	तेवढं

tevdha	तेवढा	तेवढं

tewdhan	तेवढा	तेवढं

tevadha	तेवढा	तेवढा

tewdha	तेवढा	तेवढा

tyaane	त्याने	त्याने

tyane	त्याने	त्याने

tyanech	त्यानेच	त्यानेच

trayee	त्रेे	त्रयी

trayi	ट्रे	त्रयी

tran	त्राण	त्राण

trikoot	त्रिकोट	त्रिकूट

trikut	त्रिकुट	त्रिकूट

tribhuj	त्रीभूज	त्रिभुज

tavrit	तावरीत	त्वरित

tvarit	त्वीीत	त्वरित

twarit	त्वीीत	त्वरित

tvashane	त्वाशाने	त्वेषाने

tveshane	त्वेशाने	त्वेषाने

thapave	थापववे	थापावे

danga	डागा	दंगा

dange	दागे	दंगे

dangey	दागे	दंगे

dandak	दणडक	दंडक

dandavate	दंडवते	दंडवते

dandvate	दाडवते	दंडवते

daramyan	दरा्याण	दरम्यान

darmyan	दर्ययान	दरम्यान

daramyanache	दरा्यानाी	दरम्यानचे

darmyanche	दर््यांचे	दरम्यानचे

darara	दाारा	दरारा

darja	दर्ज	दर्जा

dajracha	दााजाचा	दर्जाचा

darjacha	दा्जाचा	दर्जाचा

darjache	दर्जाचे	दर्जाचा

dajarche	दााजाचे	दर्जाचे

darjache	दर्जाचे	दर्जाचे

darjavar	दरजजावर	दर्जावर

darshavate	दर्शवते	दर्शवते

darshavte	दर्शवते	दर्शवते

darshavala	दरशशवाा	दर्शवला

darshavla	दर्शवला	दर्शवला

darshavalee	दर्शवली	दर्शवली

darshavli	दर्शविी	दर्शवली

darshavanaree	दर्शवणणारी	दर्शविणारी

darshaveenari	दर्शविनारी	दर्शविणारी

darshavinari	दर्शविनारी	दर्शविणारी

darshavoo	दर्शवू	दर्शवून

darshavoon	दर्शवून	दर्शवून

darshavu	दर्शवू	दर्शवून

darshavun	दर्शवान	दर्शवून

dalai	दलयई	दलाई

dalal	दलाळ	दलाल

dalala	दलाला	दलाला

dalalana	दळानणनना	दलालांना

dalalanna	दलालंंना	दलालांना

dalavee	दळाी	दळवी

dalvi	दळवी	दळवी

dasharath	दशाा	दशरथ

dashrath	दश््	दशरथ

dashet	दशेत	दशेत

dasara	दारा	दसरा

dasaraa	दसाा	दसरा

dasra	दारा	दसरा

daud	डौडड	दाऊद

dawood	दावडो	दाऊद

dakhavile	दाखविले	दाखविले

dakhvile	दाखविले	दाखविले

dakhavilela	दाखविलाला	दाखविलेला

dakhvilela	दाखविलाला	दाखविलेला

dakhavilelee	दाखविलीली	दाखविलेली

dakhavileli	दाखविलेली	दाखविलेली

dakhvileli	दाखविलेली	दाखविलेली

dakhavilelaya	दाखविलेलाया	दाखविलेल्या

dakhavilelya	दाखविल्ल्या	दाखविलेल्या

dakhvilelya	दाखविलेल्या	दाखविलेल्या

dadannee	दाडणणनी	दादांनी

dadanni	दाडणंनी	दादांनी

dadasaheb	दादासहहेब	दादासाहेब

dabholkaranche	दाभोळकाांचे	दाभोलकरांचे

damu	दममू	दामू

dareedryachya	दारीद्रायाच्या	दारिद्र्याच्या

daridrachya	दैरीद्रायाच्या	दारिद्र्याच्या

daridraychya	दारिद्रायाच्या	दारिद्र्याच्या

daridryachya	दारिध्रायाच्या	दारिद्र्याच्या

daas	दास	दास

das	दास	दास

dasa	दासा	दास

dasgupta	दासगुततत	दासगुप्ता

daah	दाह	दाह

dah	दाह	दाह

deepmal	दीपमाल	दिपमाळ

dipmaal	दीपमाळ	दिपमाळ

dipmal	दिप्ाळ	दिपमाळ

dirangaai	दीरंगाई	दिरंगाई

dirangai	दिरंगाई	दिरंगाई

diileep	दिलिप	दिलीप

diiliip	दीलीप	दिलीप

diiliipa	दिलिप	दिलीप

dileep	दिलीप	दिलीप

diliip	दिल्प	दिलीप

dilip	दिलीप	दिलीप

dilipa	दिलिप	दिलीप

diva	दिवा	दिवा

dubhatee	दुभती	दुभती

dubhati	दुभती	दुभती

durustisathi	दुरुस्तीसाठी	दुरुस्तीसाठी

durgeche	दुर्गेचे	दुर्गेचे

durlakshile	दुर्लक्षीली	दुर्लक्षिले

durleshile	दुर्लेेषिले	दुर्लक्षिले

dushman	दुषममा	दुश्मन

dusar	दुसर	दुसरं

dusaram	दुसरा	दुसरं

dusrn	दूसर	दुसरं

dusanyach	दुसा्याच	दुसऱ्याच

dusaryach	दुसऱ्याच	दुसऱ्याच

dusryach	दूस््याच	दुसऱ्याच

dusanyacha	दुसा्याचा	दुसऱ्याचा

dusaryacha	दुसऱ्याचा	दुसऱ्याचा

dusryacha	दूसऱ्याचा	दुसऱ्याचा

dusanyachi	दुसा्याची	दुसऱ्याची

dusaryachee	दुसऱ्याची	दुसऱ्याची

dusryachi	दुसऱ्याची	दुसऱ्याची

dusanyane	दुसऱ्याने	दुसऱ्याने

dusaryane	दुसऱ्याने	दुसऱ्याने

dusryane	दुसऱ्याने	दुसऱ्याने

dusanyala	दुसण्याला	दुसऱ्याला

dusaryala	दुसऱ्याला	दुसऱ्याला

dusryala	दुसऱ्याला	दुसऱ्याला

dooshne	दुषणे	दूषणे

dushane	दुषाे	दूषणे

dushne	दुष्े	दूषणे

dein	देनं	देईन

deina	दीईना	देईना

deth	देथ	देठ

detha	देथाा	देठ

detaana	देताना	देताना

detana	देतनना	देताना

devghar	देवघर	देवघर

devgharat	देवघा्त	देवघरात

devatance	देवतांनी	देवतांचे

devatanche	देवतांचे	देवतांचे

devtanche	देवतांचे	देवतांचे

devatanna	देवतांना	देवतांना

devtana	देवतानना	देवतांना

devatva	देवताव	देवत्व

devatwa	देवताव	देवत्व

devtatav	देवताता	देवत्व

devtatv	देवतातत	देवत्व

devasthancha	देवस्थांचा	देवस्थानचा

devsthancha	देवस्थांाा	देवस्थानचा

devsthanchaa	देवसतथांाा	देवस्थानचा

devasthanchi	देवसाथांाी	देवस्थानची

devsthanchee	देवसाथांची	देवस्थानची

devsthanchi	देवस्थांाी	देवस्थानची

devasthanchya	देवसाथांच्या	देवस्थानच्या

devsthanchya	देवस्थांच्या	देवस्थानच्या

devasthananchya	देवसाथांांच्या	देवस्थानांच्या

devstananchya	देवस्तांांच्या	देवस्थानांच्या

devsthananchya	देवस्थांंंच्या	देवस्थानांच्या

devasthanachya	देवसतथानाच्या	देवस्थानाच्या

devsthanachya	देवसथथानाच्या	देवस्थानाच्या

devasthan	देवसाथान	देवस्थाने

devasthane	देवसतथाने	देवस्थाने

devsthane	देवसाथाने	देवस्थाने

devicha	देवीचा	देवीचा

devichi	देवाची	देवीची

deviche	देवीचे	देवीचे

devila	देविला	देवीला

devisathi	देविसाठी	देवीसाठी

dehadan	देहाान	देहदान

dehdan	देहद्न	देहदान

doghinni	दोघींनी	दोघींनी

donhincha	दोनहहांचा	दोन्हींचा

dhave	ध्हावे	द्यावे

dyave	द्यावे	द्यावे

dvarapal	द्वारााल	द्वारपाल

dwarpal	द्वारपाल	द्वारपाल

dvesh	द्वेश	द्वेश

dwesh	द्वेश	द्वेश

dhanik	धािक	धनिक

dhnik	धीीक	धनिक

dharan	धरण	धरण

dharananmadhe	धरणांमध्ये	धरणांमध्ये

dharananmadhye	धरणांमध्ये	धरणांमध्ये

dharanakade	धरणाकडे	धरणाकडे

dharnakade	धरणाकडे	धरणाकडे

dharanachee	धरणांी	धरणाची

dharanachi	धरणाची	धरणाची

dharnachi	धरणाची	धरणाची

dharanamule	धरणामुळे	धरणामुळे

dharanala	धरणाला	धरणाला

dharnala	धरणाला	धरणाला

dharanavareel	धरणावरील	धरणावरील

dharanavaril	धरणावरील	धरणावरील

dharnavaril	धर्ावरील	धरणावरील

dharanasathee	धराासाठी	धरणासाठी

dharanasathi	धराासाठी	धरणासाठी

dharnasathi	धरणासाठी	धरणासाठी

dharalyane	धरल्याने	धरल्याने

dharlyane	धर््याने	धरल्याने

dhara	धाा	धरा

dharmashastra	धर्माास्त्र	धर्मशास्त्र

dharmshashtra	धर्मशास्त्र	धर्मशास्त्र

dharmashastrache	धर्मशास्त्राचे	धर्मशास्त्राचे

dharmshatrache	धर्मशात्ताराचे	धर्मशास्त्राचे

dharmashastrat	धर्मशास्त्रात	धर्मशास्त्रात

dharmshastrat	धर्मशास्त्रात	धर्मशास्त्रात

dharmeeyancha	धर्मियांचा	धर्मियांचा

dharmiyaancha	धर्मियांचा	धर्मियांचा

dharmiyancha	धर्मियांचा	धर्मियांचा

dharmiyanchi	धर्मययांची	धर्मियांची

dharmiyancha	धर्मियांचाया	धर्मियांच्या

dharmiyanchya	धर्माणांच्या	धर्मियांच्या

dharmiyansathi	धर्मयणाससाठी	धर्मियांसाठी

dharmiyasathi	धर्मीसाससाठी	धर्मियांसाठी

dhunee	धुणी	धुनी

dhuni	धुणी	धुनी

dhumakool	धुमककूळ	धुमाकूळ

dhumakul	धुमककुळ	धुमाकूळ

dhoolicha	धूळीचा	धुळीचा

dhulicha	धुळीचा	धुळीचा

dhulikan	धुळिका	धूलिकण

dhrishtadyumna	धृष्टीमयामान	धृष्टद्युम्न

dhrushtaduyamn	धृष्टाुयुमान	धृष्टद्युम्न

dhrushtadyuamn	धृष्टाुयुम	धृष्टद्युम्न

dhaivat	दैवत	धैवत

dhondo	धोंडो	धोंडो

dhorana	धोरणा	धोरणा

dhorna	धोरणा	धोरणा

dhoranancha	धोरणांचा	धोरणांचा

dhornancha	धूर्ांचा	धोरणांचा

dhorananchi	धोरणांची	धोरणांची

dhornanchi	धोरणांची	धोरणांची

dhorananchya	धोरणांच्या	धोरणांच्या

dhornanchya	धोरणांच्या	धोरणांच्या

dhorananna	धोराांना	धोरणांना

dhorannanna	धोरंांनांा्	धोरणांना

dhornanna	धोरणांना	धोरणांना

dhoranamule	धोराामुळे	धोरणामुळे

dhornamule	धोरणामुळे	धोरणामुळे

dhoranavar	धोरणावर	धोरणावर

dhornavar	धोरणावर	धोरणावर

dhoranee	धोरणी	धोरणी

dhorani	धोरणी	धोरणी

dhvaneeche	ध्वनिचे	ध्वनीचे

dhvaniche	ध्वनीचे	ध्वनीचे

dhwaniche	ध्वाीचे	ध्वनीचे

dhvaneet	ध्वनित	ध्वनीत

dhvanit	ध्वनित	ध्वनीत

dhwanit	ध्वनित	ध्वनीत

nandan	नंदा	नंदन

nakos	नकोस	नकोस

nakosa	नोोसा	नकोसा

naksheedaar	नक्षीदाव	नक्षीदार

naksheedar	नक्षीदार	नक्षीदार

nakshidar	नक्षीदार	नक्षीदार

nagarche	नारचे	नगरचे

nagarmadhil	नाराधील	नगरमधील

nagarahun	नाााून	नगरहून

nagarhun	नारहून	नगरहून

nagare	नारे	नगरे

nagre	नगरे	नगरे

najaret	नजाेत	नजरेत

najaretoon	नााेतून	नजरेतून

najaretun	नजरेतून	नजरेतून

nabh	नभ	नभ

nabhee	नभी	नभी

nabhi	नभी	नभी

namaskar	नासककरर	नमस्कार

nayanramy	नान््ीय	नयनरम्य

nayanramya	नानर््यााा	नयनरम्य

narake	नाेे	नरके

narke	ना्े	नरके

nalkande	नाकंंडे	नळकांडे

navanaveen	नवनाीन	नवनवीन

navnavin	नवन्ीन	नवनवीन

navavee	नववी	नववी

navavi	नववी	नववी

navakal	नाककलल	नवाकाळ

navkal	नवककलल	नवाकाळ

navhatach	नव्हाःच	नव्हताच

navhtach	नव्हतचच	नव्हताच

navhe	नव्हे	नव्हे

navhech	नाहहेच	नव्हेच

nasat	नसत	नसत

nast	नस्	नसत

nasatm	नसत्	नसतं

nasta	नसता	नसतं

nastn	नस्ा	नसतं

nastana	नसतानना	नसतांना

nastanna	नसतांना	नसतांना

naseer	नसीर	नसीर

nasir	नसीर	नसीर

naangi	नांगी	नांगी

nangee	नांगी	नांगी

nangi	नांगी	नांगी

naanduri	नांदुरी	नांदुरी

nanduree	नंंदुरी	नांदुरी

nanduri	नंंदुरी	नांदुरी

naikanchya	नैईकांच्या	नाईकांच्या

naikanchyaa	नैईकांच्या	नाईकांच्या

naikannee	नायकांनी	नाईकांनी

naikanni	नायकांनी	नाईकांनी

naakyavar	नाक्यावर	नाक्यावर

nakyavar	नकक्यावर	नाक्यावर

nakhoosh	नुखोष	नाखूष

nakhush	नुखुष	नाखूष

naag	नाग	नाग

nag	नाग	नाग

naagli	नागली	नागली

nagalee	नागली	नागली

nagli	नागली	नागली

naagaanchya	नागांच्या	नागांच्या

naganchya	नागांच्या	नागांच्या

naagaanna	नागांना	नागांना

nagana	नागननना	नागांना

naganna	नागांना	नागांना

naagaala	नागाला	नागाला

nagala	नागलला	नागाला

naagojee	नागोजी	नागोजी

nagojee	नागोजी	नागोजी

nagoji	नागोजी	नागोजी

nagya	नगग्य	नाग्या

nachavat	नाचवत	नाचवत

nachvat	नाचवत	नाचवत

naneghat	नानेघात	नाणेघाट

natyancha	नात्यांचा	नात्यांचा

nayab	नयया	नायब

nayar	नययर	नायर

nayara	नायराा	नायर

nalyancha	नाल्यांचा	नाल्यांचा

nalyavar	नलल्यावर	नाल्यावर

naheesa	नहहिसा	नाहीसा

nahisa	नहहिस	नाहीसा

naheese	नाहससे	नाहीसे

nahise	नाहिसे	नाहीसे

nigam	निगा	निगम

nigrah	निग्रह	निग्रह

nigraha	निग्रह	निग्रह

nighato	निघतो	निघतो

nighto	निघतो	निघतो

nighrun	निघुण	निघृण

nirghun	निर्ण	निघृण

nimantran	निमात्रण	निमंत्रण

nimantrit	निमनत्रित	निमंत्रित

niyateene	नियतीने	नियतीने

niyatine	नियतीने	नियतीने

niytine	निततीने	नियतीने

nirsan	निर््	निरसन

nirnayanmadhye	निर्णयांमध्ये	निर्णयांमध्ये

nirnyanmadhye	निर्णयांमध्ये	निर्णयांमध्ये

nirnayache	निर्णयाचे	निर्णयाचे

niranyantar	निरणययांंतर	निर्णयानंतर

nirnayanantar	निर्णयानातर	निर्णयानंतर

nirnayane	निर्णयाने	निर्णयाने

nirnayala	निर्णयाला	निर्णयाला

nirnayavar	निर्णयावर	निर्णयावर

narnayasathi	नारणणयासाठी	निर्णयासाठी

nirnayasathee	निर्णयासाठी	निर्णयासाठी

nirnayasathi	निर्णयासाठी	निर्णयासाठी

nirdeshak	निर्देशा	निर्देशक

nirdeshakanchee	निर्दशशाांची	निर्देशकांची

nirdeshakanchi	निर्देशाांची	निर्देशकांची

nirdeshkanchi	निर्देशाांची	निर्देशकांची

nirvikalp	निरवविकल्प	निर्विकल्प

nirvikalpa	निरवविकल्प	निर्विकल्प

nilya	निळ्या	निळ्या

nivadatat	निवडतात	निवडतात

nivadtat	निवडतात	निवडतात

nivdtat	निवडतात	निवडतात

nishanee	निशानी	निशाणी

nishani	निशानी	निशाणी

nisseem	निस्मी	निस्सीम

nissim	निस्मिम	निस्सीम

neelgay	नेलगेय	नीलगाय

nilagay	नीलगेय	नीलगाय

nilgaay	निलगेय	नीलगाय

nusatich	नुसतीच	नुसतीच

nustich	नससतीच	नुसतीच

napoleyanchya	नापाल्याा्या	नेपोलियनच्या

napoliyancha	नापोलियाााया	नेपोलियनच्या

nepoleonchya	नेपोलीनाच्या	नेपोलियनच्या

nemake	नेमके	नेमके

nemke	नेमके	नेमके

nehamee	नेहम्	नेहमी

nehami	नेहमी	नेहमी

nehmi	नेहमी	नेहमी

nehameepeksha	नेहमेकेक्षा	नेहमीपेक्षा

nehmipeksha	नेहििपकक्षा	नेहमीपेक्षा

naukar	नौकर	नोकर

nokar	नोकर	नोकर

nobal	नोबाल	नोबेल

nobel	नोबेल	नोबेल

nobela	नोबेला	नोबेल

november	नोवेबेबबर	नोव्हेंबर

novemberchya	नोवबबाबबरच्या	नोव्हेंबरच्या

novhembarchya	नोव्हांबरच्या	नोव्हेंबरच्या

novemberla	नोवेहेंबर्ा	नोव्हेंबरला

novhembarala	नोवनहेंबरला	नोव्हेंबरला

nya	न्या	न्या

nyaa	न्या	न्या

newtoncha	नेवूतााा	न्यूटनचा

newtonche	नेयूतचच	न्यूटनचे

newtonchya	नेवूताा्या	न्यूटनच्या

panditajee	पंढितजी	पंडितजी

panditji	पंडितजी	पंडितजी

pakshaghat	पक्षागात	पक्षाघात

pakshaghatacha	पक्षागाताचा	पक्षाघाताचा

pagadee	पगडी	पगडी

pagadi	पगडी	पगडी

pagdi	पगडी	पगडी

pachayala	पाायला	पचायला

pachayla	पाायला	पचायला

patakan	पटकन	पटकन

patkan	पटकन	पटकन

patteree	पट्टेरी	पट्टेरी

patteri	पट्टेरी	पट्टेरी

padanarya	पडणाऱ्या	पडणाऱ्या

padnarya	पडणार्या	पडणाऱ्या

padat	पडत	पडत

padataloon	पडतालून	पडताळून

padtalun	पडतळलून	पडताळून

patriket	पत्रिकेत	पत्रिकेत

patriketil	पत्रेकेतील	पत्रिकेतील

pathyakar	पा्याा	पथ्यकर

patyakar	पा्यकर	पथ्यकर

padake	पडके	पदके

padabhar	पदभरर	पदभार

padbhar	पाभरर	पदभार

paddhateenchee	पद्धतीनची	पद्धतींची

paddhatinchi	पद्धतीनची	पद्धतींची

paddhtinchi	पद्धतींची	पद्धतींची

paddhateekade	पद्धतीकडे	पद्धतीकडे

paddhatikade	पद्धतिकडे	पद्धतीकडे

paddhtikade	पद्धतीकडे	पद्धतीकडे

paddhateecha	पद्धतीचा	पद्धतीचा

paddhaticha	पद्धतीचा	पद्धतीचा

paddhticha	पद्धतीचा	पद्धतीचा

paddhateechee	पद्धतीची	पद्धतीची

paddhatichi	पद्धतीची	पद्धतीची

paddhtichi	पद्धतीची	पद्धतीची

paddhateeteel	पद्धतीतील	पद्धतीतील

paddhatitil	पद्धतितील	पद्धतीतील

paddhtital	पद्धतीतलल	पद्धतीतील

paddhateepeksha	पद्धतीपैक्षा	पद्धतीपेक्षा

paddhatipeksha	पद्धतीपैक्षा	पद्धतीपेक्षा

paddhtipeksha	पद्धतीपैस्षा	पद्धतीपेक्षा

paddhateemule	पद्धतीमुळे	पद्धतीमुळे

paddhatimule	पद्धाीमुळे	पद्धतीमुळे

paddhtimule	पद्धतीमुळे	पद्धतीमुळे

paddhatees	पद्धतीस	पद्धतीस

paddhatis	पद्धतीस	पद्धतीस

paddhtis	पद्धतिस	पद्धतीस

paddhatee	पदडदती	पध्दती

paddhati	पदडदती	पध्दती

paddhateencha	पद्दतीचचा	पध्दतींचा

paddhatincha	पद्दतींचा	पध्दतींचा

paddhateechee	पद्दतीची	पध्दतीची

paddhatichi	पदडदतीची	पध्दतीची

paddhateene	पदडदतीने	पध्दतीने

paddhatine	पदडडतीने	पध्दतीने

paramparancha	परंपरांचा	परंपरांचा

paranparancha	परंपरांचा	परंपरांचा

paramparanchi	परंपरांची	परंपरांची

paranparanchi	परंपरांची	परंपरांची

paramparanchya	परंपरांच्या	परंपरांच्या

paranparanchya	परंपरांच्या	परंपरांच्या

parka	पर्ा	परका

paradeshateel	परदेशातील	परदेशातील

pardeshatil	परदेशातील	परदेशातील

parafekt	पराेक्ट	परफेक्ट

parapheekt	परफिक्त	परफेक्ट

paraphekt	पराेक्त	परफेक्ट

parapheqt	पराेक्त	परफेक्ट

parfaikt	परािक्त	परफेक्ट

parfaiqt	परफिक्ट	परफेक्ट

parfect	परफेक्ट	परफेक्ट

parfeect	पाफीक्ट	परफेक्ट

parfekt	पर्ेक्ट	परफेक्ट

parphaikt	परािक्त	परफेक्ट

parphect	परफेक्ट	परफेक्ट

peerfeekt	पेेिक्ट	परफेक्ट

perfekt	पेेेक्ट	परफेक्ट

perfeqt	पे्ेक्ट	परफेक्ट

perphekt	पेेेक्ट	परफेक्ट

purfect	पर्ेक्ट	परफेक्ट

purfeect	पर्िक्ट	परफेक्ट

purphect	पु्ेक्ट	परफेक्ट

paravanageenech	परवानगीनिच	परवानगीनेच

paravanginech	परवानगिनिच	परवानगीनेच

parvanginech	परवानगीनिच	परवानगीनेच

paranajape	परणजजाे	परांजपे

paranjape	परंजजपे	परांजपे

parabav	परबबव	पराभव

parabhav	पाभभा	पराभव

parabhaw	पाभभा	पराभव

parabhavacha	परभभााचा	पराभवाचा

parabhawacha	परभभवाचा	पराभवाचा

parabhavachya	पाभभााच्या	पराभवाच्या

parabhawachya	पाभभााच्या	पराभवाच्या

parabhavanantar	परभभवननंतर	पराभवानंतर

parabhavanatar	परभभवणनातर	पराभवानंतर

parabhavane	परभभवाने	पराभवाने

parabhawane	परभभवणने	पराभवाने

parikashan	परीक्षा	परिक्षण

parikshan	परीक्षण	परिक्षण

paricched	परिचेछेद	परिच्छेद

parichcheda	परिच्छेडााा	परिच्छेद

parichchhed	परिचशछेच	परिच्छेद

parichhed	परिचेधेड	परिच्छेद

parinatee	परिणाी	परिणती

parinati	परिणाी	परिणती

parivarasah	परिवारासह	परिवारासह

pariwarasah	परिवारास	परिवारासह

paroksh	परोक्ष	परोक्ष

paroksha	परोक्षाा	परोक्ष

parn	पर्न	पर्ण

parna	पर्ण	पर्ण

paryavekshak	पर्याेक्षे	पर्यवेक्षक

parv	पा्व	पर्व

parva	पर्व	पर्व

parva	पावव	पर्वा

parvache	पर्वाचे	पर्वाचे

parvachya	परववाच्	पर्वाचे

parvaat	परववात	पर्वात

parvala	परववलला	पर्वात

parvat	पर्वतत	पर्वात

parvala	परववलला	पर्वाला

parsanal	परससना	पर्सनल

parsonal	परससोल	पर्सनल

pearsanal	पि्सना	पर्सनल

pearsonal	पेससनल	पर्सनल

persanal	पे्सनल	पर्सनल

personal	पे्सनन	पर्सनल

pursnal	पू्सनल	पर्सनल

palang	पांग	पलंग

pavar	पारर	पवार

pawar	पॉरर	पवार

pawarancha	पाररांचा	पवारांचा

pawaranchaa	पाररांचा	पवारांचा

pawaranchya	पाररांच्या	पवारांच्या

pawaranchyaa	पाररांच्या	पवारांच्या

pawaranna	पाररांना	पवारांना

pawarannaa	पाररांना	पवारांना

pawarannee	पारराणनी	पवारांनी

pawaranni	पाररांनी	पवारांनी

pasarate	पसरते	पसरते

pasarte	पसरते	पसरते

pahalvaan	पहलवान	पहलवान

pahalvan	पहलवणन	पहलवान

pahalwan	पहलवान	पहलवान

pahaanyas	पााण्यास	पहाण्यास

pahanyas	पााण्यास	पहाण्यास

pahaanyasathi	पााण्यासाठी	पहाण्यासाठी

pahanyasathee	पााण्यासाठी	पहाण्यासाठी

pahanyasathi	पााण्यासाठी	पहाण्यासाठी

paaus	पाऊस	पाउस

paus	पाऊस	पाउस

pause	पाऊसे	पाउस

pakadi	पककडी	पाकळी

pakali	पाकळी	पाकळी

pakdi	पककडी	पाकळी

paklee	पककळी	पाकळी

paakeeshtan	पाकीश्ठान	पाकिस्तान

paakeestan	पाकेस्टनन	पाकिस्तान

paakeshtan	पाक्स्थान	पाकिस्तान

paakestan	पाक्स्टनन	पाकिस्तान

paakiistan	पाकीस्टान	पाकिस्तान

paakishtan	पाक्ष्तान	पाकिस्तान

paakistan	पॉक्स्तान	पाकिस्तान

paaqeestan	पास्स्टनन	पाकिस्तान

paaqestan	पाक्स्टनन	पाकिस्तान

paaqistan	पॉप्स्टनन	पाकिस्तान

pakishtana	पाक्ष्तान	पाकिस्तान

pakishthan	पाक्ष्थाह	पाकिस्तान

pakistan	पॅक्स्तनन	पाकिस्तान

pakistana	पाक्स्तनना	पाकिस्तान

pakisthan	पाकीस्थान	पाकिस्तान

paqistana	पास्स्टनन	पाकिस्तान

paqisthan	पॅसीस्थान	पाकिस्तान

pakistanacha	पाक्स्तननचा	पाकिस्तानचा

pakistanchya	पास्स्तांच्	पाकिस्तानचा

pakisthancha	पाक्स्थांचा	पाकिस्तानचा

pakistanmadheel	पोस्स्तांमधील	पाकिस्तानमधील

pakistanmadhil	पोक्स्तांमधील	पाकिस्तानमधील

pakisthanmadhil	पाक्स्थांमधील	पाकिस्तानमधील

pakistanmadhye	पोस्स्तांमध्ये	पाकिस्तानमध्ये

pakisthanmaddhe	पकस्स्तांमध्ये	पाकिस्तानमध्ये

pakistanla	पाक्स्तांाा	पाकिस्तानला

pakisthanla	पाक्स्थांाा	पाकिस्तानला

paakistanvar	पाकीस्तांंर	पाकिस्तानवर

pakistanvar	पाक्स्तांंर	पाकिस्तानवर

pakisthanvar	पाक्स्थांवर	पाकिस्तानवर

pakisthanwar	पकक्स्थांंर	पाकिस्तानवर

pakistanat	पाक्स्तानात	पाकिस्तानात

pakisthanat	पकक्स्थाहाह	पाकिस्तानात

pakistanateel	पोक्स्तांातील	पाकिस्तानातील

pakistanatil	पोक्स्तांातील	पाकिस्तानातील

pakisthanatil	पकक्स्थाहाहील	पाकिस्तानातील

pakeestani	पाक्स्कीनी	पाकिस्तानी

pakeestanii	पॅक्सातानी	पाकिस्तानी

pakeystani	पाक्स्तानी	पाकिस्तानी

pakeystanii	पाकेस्तानी	पाकिस्तानी

pakiistani	पाक्स्तीनी	पाकिस्तानी

pakiistanii	पॅस्सानानी	पाकिस्तानी

pakistanee	पाक्स्तानी	पाकिस्तानी

pakistani	पाक्स्तानी	पाकिस्तानी

pakisthani	पॅक्स्थानी	पाकिस्तानी

paqeestani	पॅक्स्टननी	पाकिस्तानी

paqeystani	पॅक्स्फायी	पाकिस्तानी

paqistani	पॉस्स्तानी	पाकिस्तानी

paakhara	पाखरा	पाखरा

pakhra	पाखरा	पाखरा

pajhar	पझझर	पाझर

pathbadavar	पथठबाावर	पाठबळावर

pathbalavar	पथठबळावर	पाठबळावर

pathbalawar	पथठबळावर	पाठबळावर

pathbhed	पाठभेड	पाठभेद

pathavne	पाठवणे	पाठवणे

pathvane	पाठवणे	पाठवणे

pathwane	पाठवणे	पाठवणे

pathavnyas	पाठवण्यास	पाठवण्यास

pathvanyas	पाठवण्यास	पाठवण्यास

pathavta	पाठवता	पाठवता

pathawata	पाठवता	पाठवता

pathvata	पाठवता	पाठवता

pathavali	पाठवली	पाठवली

pathvali	पाठवली	पाठवली

pathvlee	पाठवली	पाठवली

pathavale	पाठवले	पाठवले

pathvale	पाठवले	पाठवले

pathava	पाठवा	पाठवा

pathva	पाठवा	पाठवा

pathavi	पाठाी	पाठवी

pathvee	पाठवी	पाठवी

pathvi	पाठवी	पाठवी

pathavit	पाठवित	पाठवीत

pathveet	पाठवित	पाठवीत

pathvit	पाठवित	पाठवीत

pathavu	पाठवू	पाठवू

pathcu	पाठूू	पाठवू

pathvoo	पाठवू	पाठवू

pathvu	पाठवू	पाठवू

pathavun	पाठवून	पाठवून

pathvoon	पाठवून	पाठवून

pathvun	पाठवून	पाठवून

padnyachaya	पडडण्याच्या	पाडण्याच्या

padnyachya	पाडण्याच्या	पाडण्याच्या

padnyaat	पाडण्यात	पाडण्यात

padnyat	पाडण्यात	पाडण्यात

paadvi	पाडवी	पाडवी

padvi	पाडवी	पाडवी

padwi	पदडवी	पाडवी

paantavane	पाणतावाे	पानतावणे

pantavane	पंणतववाे	पानतावणे

papkshalan	पपपक्षालन	पापक्षालन

payathya	पायथ्या	पायथ्या

paythya	पायथ्या	पायथ्या

payathayache	पायथायाचे	पायथ्याचे

payathyache	पायथ्याचे	पायथ्याचे

payathyachya	पायथ्याच्या	पायथ्याच्या

paythyachya	पायथ्याच्या	पायथ्याच्या

payathyapasoon	पाया्यापासून	पायथ्यापासून

payathyapasun	पाया्यापासून	पायथ्यापासून

payathyala	पायथ्याला	पायथ्याला

payathyashee	पायथ्याशी	पायथ्याशी

payathyashi	पाया्याशी	पायथ्याशी

payal	पाया	पायल

paramparik	पररापररिक	पारंपारिक

paark	पार्क	पार्क

paarq	पार्क	पार्क

park	परर्क	पार्क

parq	परर्क	पार्क

parkacha	प्रककाा	पार्कचा

parkcha	पररखखचा	पार्कचा

parkche	पररखकचे	पार्कचे

paarkar	पार्कर	पार्कर

paarker	पारककर	पार्कर

paarqar	पारककर	पार्कर

paarqer	पारककर	पार्कर

parkar	पररककर	पार्कर

parkara	पररककर	पार्कर

parker	पररककर	पार्कर

parqara	पररककर	पार्कर

parqer	पररककर	पार्कर

parkvar	पररककवर	पार्कवर

palo	पालो	पालो

paloo	पालू	पालो

paalee	पाली	पाळी

pali	पाली	पाळी

paleeche	पालीचे	पाळीचे

paliche	पललीचे	पाळीचे

paleet	पालीत	पाळीत

palit	पालीत	पाळीत

pavala	पावला	पावला

pavla	पावला	पावला

pawla	पावला	पावला

pavalavar	पावलावर	पावलावर

pavlavar	पावलावर	पावलावर

pawlawar	पावलावर	पावलावर

pasa	पास	पाशा

pasha	पासा	पाशा

pashha	पाशा	पाशा

pahije	पहहिजे	पाहिजे

pingat	पिंगत	पिंगट

pindadan	पिंदसनन	पिंडदान

pinddan	पिंडसनन	पिंडदान

pital	पितळ	पितळ

pitalee	पितळी	पितळी

pitali	पितळी	पितळी

pitamah	पितमम	पितामह

pujalee	पुजली	पुजली

pujali	पुजली	पुजली

pujale	पूजले	पुजले

pudhachee	पुढची	पुढची

punatamba	पुनाामबा	पुणतांबा

puntamba	पुंताबबा	पुणतांबा

punarbharan	पुनर्भरण	पुनर्भरण

puranbharan	पुररभभाण	पुनर्भरण

puravato	पुरवतो	पुरवतो

purichya	पुरिच्या	पुरीच्या

puruchya	पुरूच्या	पुरीच्या

purushatva	पुरुषा्व	पुरुषत्व

purushottam	पुरुषात्त	पुरुषोत्तम

pureshee	पुरेशी	पुरेशी

pureshi	पुरेशी	पुरेशी

pooshti	पुष्टी	पुष्टी

pushtee	पुष्टी	पुष्टी

pushti	पुष्टी	पुष्टी

purtisathi	पूर्तिसाठी	पूर्तीसाठी

purvajanche	पूर्वजानने	पूर्वजांचे

purvjanche	पूर्वजांने	पूर्वजांचे

purvaniyojit	पुर्वाियुिित	पूर्वनियोजित

purvniyojit	परर्विियुदित	पूर्वनियोजित

poorvsthitit	पूरससस्थितीत	पूर्वस्थितीत

purvasthitit	पूर्वस्थितीत	पूर्वस्थितीत

purvsthitit	पूर्वस्थितित	पूर्वस्थितीत

poorva	पूर्व	पूर्वा

purva	पूर्व	पूर्वा

purvekade	पूर्वेकडे	पूर्वेकडे

prithvi	पृथ्वी	पृथ्वी

pruthvi	पृथ्वी	पृथ्वी

prithvicha	पृथ्वीचा	पृथ्वीचा

pruthvicha	पृष्वीचा	पृथ्वीचा

prithviche	पृथ्वीचे	पृथ्वीचे

pruthviche	पृथ्वीचे	पृथ्वीचे

prithvichya	पृथ्वीच्या	पृथ्वीच्या

pruthvichya	प्थ्वीच्या	पृथ्वीच्या

prithvipasun	पृथ्वीपासून	पृथ्वीपासून

pruthvipasoon	पृथ्वीपासून	पृथ्वीपासून

pruthvipasun	पृथ्वीपासून	पृथ्वीपासून

prithvila	पृथ्वीला	पृथ्वीला

pruthvila	पृथ्वीला	पृथ्वीला

prithvivar	पृथ्वीवर	पृथ्वीवर

pruthvivar	पृथ्वीरर	पृथ्वीवर

prithvivaril	पृथ्वीवरील	पृथ्वीवरील

pruthvivaril	पृथ्वीवरील	पृथ्वीवरील

packeet	पाकीट	पॅकेट

packet	पाक्ट	पॅकेट

pacqet	पाक्ट	पॅकेट

pakeet	पाकीट	पॅकेट

paket	पककेट	पॅकेट

paqet	पाक्ट	पॅकेट

pyackeet	पॅक्क	पॅकेट

pyacket	प्क्क	पॅकेट

pyacqet	प्क्ट	पॅकेट

pyakeet	प्कि	पॅकेट

pyaket	पॅक्ट	पॅकेट

pyaqet	प्क्ट	पॅकेट

parismadheel	पररिसमधील	पॅरिसमधील

parismadhil	पररिसमधील	पॅरिसमधील

parisla	पररससल	पॅरिसला

parisvar	पररिसवर	पॅरिसवर

pariswar	पररिस्र	पॅरिसवर

palestain	पललिस्टिनन	पॅलेस्टाईन

palestine	पललेस्टिनन	पॅलेस्टाईन

paintar	पेंटर	पेंटर

painteer	पैंटर	पेंटर

painter	पेंटर	पेंटर

peentar	पेंटर	पेंटर

peenteer	पेंटर	पेंटर

pentar	पेंटर	पेंटर

penter	पेंटर	पेंटर

pendharkar	पेंढररकर	पेंढारकर

page	पाग	पेज

peg	पेग	पेज

pej	पेज	पेज

paperche	पपपरचे	पेपरचे

papermadhe	पपपरमध्ये	पेपरमध्ये

papermadhye	पाररमध्ये	पेपरमध्ये

papars	पपपर्स	पेपर्स

papeers	पपपर्स	पेपर्स

papers	पारर्स	पेपर्स

peepars	पेरर्स	पेपर्स

pepars	पेरर्स	पेपर्स

pari	पररी	पेरी

parry	पेरी	पेरी

peeri	पेरी	पेरी

peerry	पेर्	पेरी

peri	पेरी	पेरी

perii	पेरी	पेरी

perri	पेरी	पेरी

perry	पेरी	पेरी

pery	पेरी	पेरी

peshavepad	पेशवेपद	पेशवेपद

peshvepad	पेशवेपद	पेशवेपद

paithanee	पैठाी	पैठणी

paithani	पैठाी	पैठणी

paithni	पैठाी	पैठणी

patar	पतटर	पॉटर

patter	पटट्	पॉटर

petar	पेटर	पॉटर

potar	पोटर	पॉटर

poter	पोटर	पॉटर

pottar	पोटर	पॉटर

potter	पोट्	पॉटर

pot	पोट	पोट

potchya	पोटच्या	पोटच्या

potakade	पोटाकडे	पोटाकडे

potache	पोटाचे	पोटाचे

potat	पोटात	पोटात

potateel	पोटातील	पोटातील

potatil	पोटातील	पोटातील

potamaddhe	पोटामध्ये	पोटामध्ये

potamadhe	पोटामध्ये	पोटामध्ये

potamadhye	पोटामध्ये	पोटामध्ये

potala	पोटलला	पोटाला

potashee	पोटाशी	पोटाशी

potashi	पोटाशी	पोटाशी

potee	पोटी	पोती

poti	पोटी	पोती

pofalee	फोफली	पोफळी

pofali	पोफली	पोफळी

pofdi	पोफडी	पोफळी

pophadi	पोफाी	पोफळी

pophalee	पोफली	पोफळी

pophali	पोफली	पोफळी

portugesejancha	पोर्तुगेसाससेत	पोर्तुगीजांचा

portugijancha	पोर्तुगीजनंचा	पोर्तुगीजांचा

potuguesancha	पोटुगुगावाचचा	पोर्तुगीजांचा

portugesejani	पोर्तगगेसाससी	पोर्तुगीजांनी

portugijanni	पोर्तगगींनंनी	पोर्तुगीजांनी

portuguesanni	पोर्तुगासासकीस	पोर्तुगीजांनी

poliocha	पोलिचचा	पोलिओचा

poloocha	पोलूचचा	पोलिओचा

poleesannee	पोलिसांनी	पोलीसांनी

policanni	पोलिसांनी	पोलीसांनी

polisanni	पोलिसांनी	पोलीसांनी

poleechee	पोलीची	पोळीची

poleechi	पोलीची	पोळीची

polichi	पोलीची	पोळीची

poshanasathee	पोषणासाठी	पोषणासाठी

poshanasathi	पोषाासाठी	पोषणासाठी

poshnasathi	पोषणासाठी	पोषणासाठी

poostal	पोस्टल	पोस्टल

poostala	पोस्टल	पोस्टल

poshtal	पोष्टळ	पोस्टल

poshtala	पोष्टा	पोस्टल

postal	पोस्टल	पोस्टल

postala	पोस्टल	पोस्टल

paugandavastheteel	पौगंडववसाथातील	पौगंडावस्थेतील

paugandavasthetil	पौगंडावसातितील	पौगंडावस्थेतील

pougandavasthetil	पौगंडाससातितील	पौगंडावस्थेतील

prakat	प्रका	प्रकट

prakatapane	प्रकतपणे	प्रकटपणे

prakatpane	प्रकतपणे	प्रकटपणे

prakatala	प्रकाला	प्रकटला

prakar	प्रकरर	प्रकार

prakarancha	प्रकररांचा	प्रकारांचा

prakaranchee	प्रकारांची	प्रकारांची

prakaranchi	प्रकररांची	प्रकारांची

prakaranche	प्रकारांचे	प्रकारांचे

prakaranna	प्रकररांना	प्रकारांना

prakaranpaikee	प्रकारांपैकी	प्रकारांपैकी

prakaranpaiki	प्रकांांपैकी	प्रकारांपैकी

prakaransathee	प्रकारांसाठी	प्रकारांसाठी

prakaransathi	प्रकारांसाठी	प्रकारांसाठी

prakarat	प्रकररात	प्रकारात

prakarateel	प्रकारातील	प्रकारातील

prakaratil	प्रकारातील	प्रकारातील

prakaratoon	प्रकारातून	प्रकारातून

prakaratun	प्रकारातून	प्रकारातून

prakarane	प्रकररणने	प्रकाराने

prakaramule	प्रकारामुळे	प्रकारामुळे

prakaravaroon	प्रकारववरून	प्रकारावरून

prakaravarun	प्रकारववरून	प्रकारावरून

prakaras	प्रकारसस	प्रकारास

prakarasathee	प्रकारससाठी	प्रकारासाठी

prakarasathi	प्रकारासाठी	प्रकारासाठी

prakriyecha	प्रक्रियेचा	प्रक्रियेचा

prakriyechya	प्रक्रियेच्या	प्रक्रियेच्या

prakriyet	प्रक्रियेत	प्रक्रियेत

prakriyene	प्रक्रियेने	प्रक्रियेने

prakriyepasoon	प्रक्रियेपासून	प्रक्रियेपासून

prakriyepasun	प्रक्रियपपासून	प्रक्रियेपासून

prakriyemule	प्रक्रियेमुळे	प्रक्रियेमुळे

prakriyela	प्रक्रियाला	प्रक्रियेला

prakriyeshee	प्रक्रियेशी	प्रक्रियेशी

prakriyeshi	प्रक्रियेशी	प्रक्रियेशी

prakriyes	प्रक्रियेस	प्रक्रियेस

prajaanan	प्रजानन	प्रजाजन

prajajan	प्रजाजन	प्रजाजन

prajanan	प्रजननन	प्रजाजन

prajapatee	प्रजापती	प्रजापती

prajapati	प्रजापती	प्रजापती

pranay	प्राय	प्रणय

pranayachya	प्राााच्या	प्रणयाच्या

pranete	प्राेते	प्रणेते

pratapgad	प्रतापाा	प्रतापगड

pratapagadavareel	प्रतगगदाावरील	प्रतापगडावरील

pratapgadavareel	प्रतापदाावरील	प्रतापगडावरील

pratapgadavaril	प्रतपपदाावरील	प्रतापगडावरील

prateenidhitv	प्रतिनिधित	प्रतिनिधीत्व

pratinidheetv	प्रतिनिधित	प्रतिनिधीत्व

pratinidhitv	प्रतिनिधित्व	प्रतिनिधीत्व

pratinidhitva	प्रतिनिधित्व	प्रतिनिधीत्व

pratipal	प्रतिपाल	प्रतिपाळ

pratipla	प्रतिपाल	प्रतिपाळ

pratishthan	प्रतिष्ठान	प्रतिष्ठान

pratisthan	प्रतिसाठान	प्रतिष्ठान

pratishthanacha	प्रतिष्ठानाा	प्रतिष्ठानचा

pratishthancha	प्रतिष्ठांचा	प्रतिष्ठानचा

pratisthancha	प्रतिस्ठांचा	प्रतिष्ठानचा

pratishthanachee	प्रतिष्ठानाी	प्रतिष्ठानची

pratishthanchi	प्रतिष्ठांची	प्रतिष्ठानची

pratisthanchi	प्रतिस्ठांची	प्रतिष्ठानची

pratishthanache	प्रतिषाठानाे	प्रतिष्ठानचे

pratishthanche	प्रतिष्ठांाे	प्रतिष्ठानचे

pratishthanachya	प्रतिष्ठाना्या	प्रतिष्ठानच्या

pratishthanchya	प्रतिष्ठांच्या	प्रतिष्ठानच्या

pratishthanane	प्रतिष्ठानाा	प्रतिष्ठानने

prathecha	प्रथेचा	प्रथेचा

pradeshaatach	प्रदेशाता	प्रदेशातच

pradeshatach	प्रदेशातच	प्रदेशातच

pradeshatch	प्रदेशातच	प्रदेशातच

prapanch	प्रपाच	प्रपंच

prapancha	प्रााचा	प्रपंच

prapanchat	प्रपाचात	प्रपंचात

prabodhankar	प्रबोधनकरर	प्रबोधनकार

pramanpatr	प्रमांपत्र	प्रमाणपत्र

pramanpatra	प्रमांपत्र	प्रमाणपत्र

pramanbhut	प्रमाभभित	प्रमाणभूत

pramanech	प्रमानेच	प्रमाणेच

pramannech	प्राानचं	प्रमाणेच

pramookh	प्रमुख	प्रमूख

pramukh	प्रमुख	प्रमूख

prayog	प्रयोग	प्रयोग

prayogshaleteel	प्रयोगशालेतील	प्रयोगशाळेतील

prayogshaletil	प्रयोगशेलीतील	प्रयोगशाळेतील

prayogancha	प्रयोगांचा	प्रयोगांचा

prayoganchee	प्रयोगांची	प्रयोगांची

prayoganchi	प्रयोगांची	प्रयोगांची

prayogant	प्रयोगंंत	प्रयोगांत

prayoganmadhye	प्रयोगंंमध्ये	प्रयोगांमध्ये

prayogaantee	प्रयोगंंंती	प्रयोगाअंती

prayogaanti	प्रयोगांंती	प्रयोगाअंती

prayogache	प्रयोगाचे	प्रयोगाचे

prayogachey	प्रयोगाचे	प्रयोगाचे

prayogachya	प्रयोगाच्या	प्रयोगाच्या

prayogateel	प्रयोगातील	प्रयोगातील

prayogatil	प्रयोगातील	प्रयोगातील

prayoganantar	प्रयोगणनंतर	प्रयोगानंतर

prayogananter	प्रयोगणनंतर	प्रयोगानंतर

prayogaala	प्रयोगाला	प्रयोगाला

prayogala	प्रयोगळला	प्रयोगाला

prayogasaathi	प्रयोगससाठी	प्रयोगासाठी

prayogasadhee	प्रयोगसशाधील	प्रयोगासाठी

prayogasathi	प्रयोगासाठी	प्रयोगासाठी

pravan	प्रवण	प्रवण

pravaranagar	प्रवरणनार	प्रवरानगर

pravranagar	प्रवर्नगर	प्रवरानगर

pravasvarnan	प्रवससररणना	प्रवासवर्णन

pravasvarnane	प्रवससारणनाे	प्रवासवर्णने

praveshahee	प्रवेशही	प्रवेशही

praveshahi	प्रवेशही	प्रवेशही

praveshacha	प्रवेशाचा	प्रवेशाचा

praveshat	प्रवेशात	प्रवेशात

praveshasathee	प्रवेशासाठी	प्रवेशासाठी

praveshasathi	प्रवेशासाठी	प्रवेशासाठी

prashasan	प्रशासन	प्रशासन

prashashan	प्रशासन	प्रशासन

prashasanat	प्रशासनात	प्रशासनात

prashasanane	प्रशासननने	प्रशासनाने

prashasanala	प्रशासनलला	प्रशासनाला

prashasnala	प्रशासनलला	प्रशासनाला

prashasanavar	प्रशासनावर	प्रशासनावर

prashasnavar	प्रशासनावर	प्रशासनावर

prashasanik	प्रशासििक	प्रशासनिक

prasadacha	प्रसादाचा	प्रसादाचा

prasadachee	प्रसादाची	प्रसादाची

prasadachi	प्रसादाची	प्रसादाची

prasootee	प्रसूती	प्रसूति

prasuti	प्रसूती	प्रसूति

praant	प्रांत	प्रांत

prant	प्रांत	प्रांत

prantanchee	प्रंंतांची	प्रांतांची

prantanchi	प्रांतांची	प्रांतांची

prantaant	प्रांतांत	प्रांतांत

prantant	प्रांतांत	प्रांतांत

praantacha	प्रांताचा	प्रांताचा

prantacha	प्रांतचचा	प्रांताचा

prantache	प्रांताचे	प्रांताचे

prantachey	प्रांतचचे	प्रांताचे

prantateel	प्रंंतातील	प्रांतातील

prantatil	प्रांतातील	प्रांतातील

prantatoon	प्राततातून	प्रांतातून

prantatun	प्रांतातून	प्रांतातून

praantamadhye	प्रांतामध्ये	प्रांतामध्ये

prantamadhye	प्रांतामध्ये	प्रांतामध्ये

prantaala	प्रंंतलला	प्रांताला

prantala	प्रांतलला	प्रांताला

prantavar	प्रांतववर	प्रांतावर

prantawar	प्रंंतावर	प्रांतावर

praantik	प्रांतिक	प्रांतिक

prantik	प्रांतिक	प्रांतिक

pranteey	प्रांतीय	प्रांतीय

prantiy	प्रांतीय	प्रांतीय

prachin	प्राचीन	प्राचिन

prajakta	प्रजजक्ता	प्राजक्ता

prajkta	प्राजक्ता	प्राजक्ता

pranahee	प्राणहा	प्राणही

pranahi	प्राणही	प्राणही

pranavar	प्राणववर	प्राणावर

pratah	प्रतत	प्रातः

pratha	प्रथथ्	प्रातः

prayojakatv	प्रायोकक्ाव	प्रायोजकत्व

prayojaktv	प्रययोकक््व	प्रायोजकत्व

prayojkatv	प्रोयोपक््व	प्रायोजकत्व

prayojktv	प्रायोकक््व	प्रायोजकत्व

planeet	प्लॅणिट	प्लॅनेट

planet	प्लॅनेट	प्लॅनेट

fandachya	फादाच्या	फंडाच्या

fundachya	फुडाच्या	फंडाच्या

fandat	फाडात	फंडात

fundat	फुडात	फंडात

fakeera	फे्रा	फकिरा

fakira	फािरा	फकिरा

phakeera	फॅ्रा	फकिरा

phakira	फा्रा	फकिरा

fateeh	फतीह	फतेह

fateh	फतेह	फतेह

fatteeh	फतीह	फतेह

fatteh	फट्त	फतेह

feteh	फेेह	फतेह

fetteh	फेेत	फतेह

phateeh	फतीह	फतेह

phateh	फतेह	फतेह

phatteh	फट्ठ	फतेह

pheteh	फेेह	फतेह

farfat	फफफट	फरफट

pharphat	फरफट	फरफट

fargyusan	फर्गससससा	फर्ग्युसन

ferguson	फर्गसससस	फर्ग्युसन

furgusan	फर्गससुसन	फर्ग्युसन

fadbhaji	फळभाजी	फळभाजी

falbhaaji	फळभाजी	फळभाजी

falbhaji	फळभाजी	फळभाजी

phadbhaji	फळभाजी	फळभाजी

phalbhaji	फळभाजी	फळभाजी

favaranee	फाररणी	फवारणी

favarani	फाररणी	फवारणी

favarni	फारर्ी	फवारणी

phavarni	फारर्ी	फवारणी

far	फरर	फार

phar	फरर	फार

farma	फॉर्म	फार्मा

pharma	फार्म	फार्मा

falani	फललणी	फाळणी

falni	फालणी	फाळणी

phalni	फालणी	फाळणी

falanicha	फललणीचा	फाळणीचा

falnicha	फाळणीचा	फाळणीचा

falnichya	फाळणीच्	फाळणीचा

phalnichya	फललणीच्	फाळणीचा

falaniche	फलळणीचे	फाळणीचे

falniche	फललणीचे	फाळणीचे

phalniche	फालणीचे	फाळणीचे

falanichya	फललणीच्या	फाळणीच्या

falnichya	फालणीच्या	फाळणीच्या

phalnichya	फललणीच्या	फाळणीच्या

fadanimule	फडडणीमुळे	फाळणीमुळे

falnimule	फालणीमुळे	फाळणीमुळे

phalnimule	फालणीमुळे	फाळणीमुळे

finiesh	फिनिहिश	फिन्निश

finish	फिनिहिश	फिन्निश

finnies	फिन्सिस	फिन्निश

finniesh	फिनिनिश	फिन्निश

finnieshh	फिनिनिश	फिन्निश

finnis	फिन्सिस	फिन्निश

finnish	फिन्सिश	फिन्निश

finnishh	फिन्हिश	फिन्निश

phinish	फिनिसिश	फिन्निश

phinniesh	फिनिहिश	फिन्निश

phinnis	फिनिसिस	फिन्निश

phinnish	फिनिसिश	फिन्निश

phinnishh	फिनिहिश	फिन्निश

fifa	फिफा	फिफा

fifachya	फिफाई्या	फिफाच्या

feed	फेड	फीड

fid	फीड	फीड

fida	फीड	फीड

fiid	फीड	फीड

pheed	फेड	फीड

phid	फीड	फीड

phida	फीड	फीड

phiida	फीड	फीड

fukat	फुकट	फुकट

phookat	फुकट	फुकट

phukat	फुकट	फुकट

fulpakharanche	फुल्ाकाांचे	फुलपाखरांचे

fulpakhranche	फुल्ाषा्ंचे	फुलपाखरांचे

fulpakhranchey	फुल््क््ंचे	फुलपाखरांचे

phulpakharanche	फुल्ाराांचे	फुलपाखरांचे

phulpakhranchey	फुल््र््ंच्	फुलपाखरांचे

fulpakharanchya	फुलफकका्ंच्या	फुलपाखरांच्या

fulpakhranchya	फुल््का्ंच्या	फुलपाखरांच्या

phulpakharanchya	फुलफाका्ंच्या	फुलपाखरांच्या

phulpakhranchya	फुल््का्ंच्या	फुलपाखरांच्या

fulpakharala	फुल्ाकालला	फुलपाखराला

fulpakhraala	फुल्खखराला	फुलपाखराला

phulpakharala	फुलफाकरलला	फुलपाखराला

phulpakhraala	फुल्ाकराला	फुलपाखराला

fairo	फेरो	फेरो

fairoo	फेरो	फेरो

faro	फारो	फेरो

feero	फेरो	फेरो

fero	फेरो	फेरो

feroo	फिरू	फेरो

phairo	फेरो	फेरो

pharo	फारो	फेरो

pheero	फेरो	फेरो

phero	फेरो	फेरो

pheroo	फेरू	फेरो

facebaak	फॅक्कक	फेसबुक

facebook	फास्ॉक	फेसबुक

facebooq	फॅक्ॉक	फेसबुक

facebuk	फॅकककक	फेसबुक

facebuq	फॅक्कक	फेसबुक

faceebook	फास्कक	फेसबुक

faceebuk	फॅक्कक	फेसबुक

fesabuk	फेसबूक	फेसबुक

phacebook	फॅक्कक	फेसबुक

phacebuk	फॅक्कक	फेसबुक

pheesabuk	फिसबकक	फेसबुक

phesabuk	फेसबकक	फेसबुक

phesabuka	फेसबकक	फेसबुक

phesabuq	फेसबकक	फेसबुक

freez	फ्रेज	फ्रीज

fridge	फ्रिजे	फ्रीज

baglow	बागल	बंगलो

banglo	बंगलो	बंगलो

bungalow	बंगला	बंगलो

bakharee	बखरी	बखरी

bakhari	बखरी	बखरी

bag	बा	बग

bug	बग	बग

bagal	बाळ	बगल

bageecha	बाीचा	बगीचा

bagicha	बाीचा	बगीचा

baghitala	बघितला	बघितला

baghitla	बघितला	बघितला

bataliyana	बाललिया	बटालियन

battalian	बटललननन	बटालियन

battalion	बटललिनन	बटालियन

betaliyana	बेललिया	बटालियन

bettalion	बेललीनन	बटालियन

batu	बटू	बटु

badodekar	बोोदेकर	बडोदेकर

badhatya	बात्या	बढत्या

badhtya	बात्या	बढत्या

badak	बाक	बदक

badalave	बदलावे	बदलावे

badlave	बदलावे	बदलावे

bananaree	बनणारी	बनणारी

bananari	बनणारी	बनणारी

bannari	बनणारी	बनणारी

banale	बनले	बनले

banle	बनले	बनले

banalela	बनलेला	बनलेला

banlela	बनलेला	बनलेला

banseelal	बनससेल	बन्सीलाल

bansilal	बनससलल	बन्सीलाल

barbaad	बर्ाड	बरबाद

barbad	बर्ाड	बरबाद

barack	बाकक	बराक

baracq	बाकक	बराक

barak	बरकक	बराक

baraka	बाकक	बराक

baraq	बाकक	बराक

baraqa	बाकक	बराक

barrack	बा्कर	बराक

baraaha	बााह	बराहा

baraha	बााह	बराहा

barobarinech	बरोबरीनचच	बरोबरीनेच

bargaman	बर्गमा	बर्गमन

bargman	बर्गम्	बर्गमन

bergman	बर्गम	बर्गमन

barnsa	बा्नास	बर्न्स

barnsha	बा्णशस	बर्न्स

bunrsh	बन्नसस	बर्न्स

burns	बर्न्स	बर्न्स

burnsh	बर्न	बर्न्स

barfal	बर्फलल	बर्फाळ

barma	बर्म	बर्मा

berma	बर्मा	बर्मा

burma	बर्मा	बर्मा

bala	बाा	बला

balaa	बाा	बला

balache	बााचे	बलाचे

balane	बााने	बलाने

ballal	बळलला	बल्लाळ

bashee	बशी	बशी

bashi	बशी	बशी

basate	बसते	बसते

baste	बसते	बसते

basato	बसतो	बसतो

basto	बसतो	बसतो

basawava	बसवावा	बसवावा

basvava	बसवावा	बसवावा

baseel	बेेल	बसेल

baseela	बेेला	बसेल

basel	बेेल	बसेल

basela	बेेला	बसेल

bases	बसेस	बसेल

bashel	बेेल	बसेल

bashela	बेेला	बसेल

busel	बसेल	बसेल

bahudha	बहुदा	बहुधा

baangdi	बांगडी	बांगडी

bangadee	बांगडी	बांगडी

bangadi	बंंगाी	बांगडी

baandani	बांदणी	बांधणी

bandhanee	बांधणी	बांधणी

bandhani	बांधणी	बांधणी

baandanichi	बांडणीची	बांधणीची

baandhaneechee	बांधणीची	बांधणीची

bandhanichi	बांधणीची	बांधणीची

baandaniche	बांडणीचे	बांधणीचे

baandhaneeche	बांधणीचे	बांधणीचे

bandhaniche	बांधणीचे	बांधणीचे

baandanichya	बांडणीच्या	बांधणीच्या

baandhaneechya	बांधणीच्या	बांधणीच्या

bandhanichya	बांधणीच्या	बांधणीच्या

baandanisaathi	बंंडणीसाठी	बांधणीसाठी

bandhaneesathee	बंंधण्साठी	बांधणीसाठी

bandhanisathi	बंंधण्साठी	बांधणीसाठी

bandhavee	बांधावी	बांधावी

bandhavi	बांधावी	बांधावी

baankot	बाँकोट	बाणकोट

bancoat	बँँकोट	बाणकोट

bankot	बँँकोट	बाणकोट

badashaha	बदळाा	बादशहा

badshaha	बाळशा	बादशहा

badshha	बाळशा	बादशहा

badashahachya	बदळशााच्या	बादशहाच्या

badshahachya	बाळशााच्या	बादशहाच्या

badshhachya	बाळशााच्या	बादशहाच्या

badashahane	बदळशााने	बादशहाने

badshahane	बाळशााने	बादशहाने

baburao	बाबूराव	बाबुराव

baburav	बाबूराव	बाबुराव

babhadgaon	बहभागाव	बाभळगाव

babhadgav	बाभगगाव	बाभळगाव

babhalagav	बाभागाव	बाभळगाव

bhabhalgaon	भाभलगाव	बाभळगाव

baravya	बाराव्या	बाराव्या

barshee	बारशशी	बार्शी

barshi	बारशशी	बार्शी

barsheet	बररशशित	बार्शीत

barshit	बररशशित	बार्शीत

balakancha	बालकांचा	बालकांचा

balakanchee	बालकांची	बालकांची

balakanchi	बालकांची	बालकांची

balakanchya	बालकांच्या	बालकांच्या

balakanna	बालाांना	बालकांना

balakacha	बालकाचा	बालकाचा

balkacha	बालकाचा	बालकाचा

balakachee	बालकाची	बालकाची

balakachi	बालकाची	बालकाची

balkachi	बालकाची	बालकाची

balakas	बालकास	बालकास

balkas	बालकास	बालकास

balageet	बाळाीत	बालगीत

balgeet	बाळगीत	बालगीत

balaghat	बळळघघात	बालाघाट

balaghatachya	बललघघततचच्या	बालाघाटाच्या

balghatachya	बललघघटताच्या	बालाघाटाच्या

bavane	बावाे	बावणे

bavne	बावने	बावणे

bawne	बावणे	बावणे

basamati	बससमती	बासमती

basamatii	बससाती	बासमती

basameti	बससमती	बासमती

basmatee	बसस्ती	बासमती

basmati	बसस्ती	बासमती

basmatii	बसस्ती	बासमती

basmetee	बसस्ती	बासमती

basmeti	बसस्ती	बासमती

bicharee	बिचारी	बिचारी

bichari	बिचारी	बिचारी

been	बीन	बिन

biin	बीय	बिन

bin	बीन	बिन

beena	बीना	बिना

biina	बीना	बिना

bina	बीना	बिना

bimal	बिमल	बिमल

biroba	बिरोबा	बिरोबा

baadha	बाढाहा	बुद्ध

boodh	बूढ्ह	बुद्ध

buddh	बुड्ध	बुद्ध

buddha	बुड्ध	बुद्ध

budh	बुढ	बुद्ध

buddhancha	बुद्धांचा	बुद्धांचा

buddhanche	बुद्धांचे	बुद्धांचे

budhanche	बुध्धांचे	बुद्धांचे

buddhanchya	बुद्धांच्या	बुद्धांच्या

buddhana	बुड्धानना	बुद्धांना

buddhanna	बुद्धांना	बुद्धांना

buddhanni	बुद्धांनी	बुद्धांनी

budhannee	बुध्णांनी	बुद्धांनी

budhanni	बुधाधांनी	बुद्धांनी

buddhachi	बुध्धाची	बुद्धाची

buddhala	बुड्धाला	बुद्धाला

budhkar	बुधार	बुधकर

buldhana	बलल्ाना	बुलढाणा

bank	बँकक	बॅंक

back	बॉक	बॅक

bacq	बकक	बॅक

bak	बकक	बॅक

baq	बकक	बॅक

betee	बेटी	बेटी

beti	बेटी	बेटी

badar	बादर	बेडर

badeer	बादर	बेडर

bader	बादर	बेडर

bedar	बेदा	बेडर

beedar	बीदर	बेडर

bebanav	बेबााव	बेबनाव

bebnav	बेबनाव	बेबनाव

baby	बाबी	बेबी

bebee	बेबी	बेबी

bebi	बेबी	बेबी

bebii	बेबी	बेबी

beby	बेबी	बेबी

beebee	बीबी	बेबी

beebi	बीबी	बेबी

beeby	बीबी	बेबी

belsare	बेल्ाे	बेलसरे

belgium	बेल्गिकम	बेल्जियम

belgiumchya	बेलगगममचच्या	बेल्जियमच्या

behare	बेहरे	बेहरे

behere	बेहेे	बेहरे

baksha	बाक्स	बॉक्स

baqsa	बॉक्स	बॉक्स

bauks	बॉक्स	बॉक्स

bauksh	बुक्स	बॉक्स

bauqs	बॉक्स	बॉक्स

bax	बाक्स	बॉक्स

boks	बोक्स	बॉक्स

box	बॉक्स	बॉक्स

baksar	बकक्सर	बॉक्सर

bakser	बकक्सर	बॉक्सर

baqsar	बॉक्सर	बॉक्सर

baxer	बेक्रर	बॉक्सर

boksar	बोक्सर	बॉक्सर

bokser	बोक्सर	बॉक्सर

boqser	बोक्सर	बॉक्सर

boxar	बोकररर	बॉक्सर

boxer	बोसरसर	बॉक्सर

bab	बाब	बॉब

baub	बॉब	बॉब

bob	बॉब	बॉब

babbi	बबबी	बॉबी

babi	बाबी	बॉबी

babii	बाबी	बॉबी

baby	बाबी	बॉबी

baubbi	बॉबी	बॉबी

baubbii	बॉबी	बॉबी

baubi	बाबी	बॉबी

baubie	बाबी	बॉबी

baubiie	बाबी	बॉबी

bauby	बॉबी	बॉबी

bobbi	बॉबी	बॉबी

bobbie	बॉब्	बॉबी

bobbii	बॉबी	बॉबी

bobbiie	बॉबी	बॉबी

bobby	बॉबी	बॉबी

bobi	बॉबी	बॉबी

bobie	बोबी	बॉबी

boby	बॉबी	बॉबी

bobhata	बोहतत	बोभाटा

bor	बरर	बोर

bore	बोरे	बोर

borachee	बोरचची	बोराची

borachi	बोरचची	बोराची

borivalee	बोरीवली	बोरिवली

borivali	बोरववली	बोरिवली

board	बॉरडड	बोर्ड

booard	बुरडड	बोर्ड

boord	बोरडड	बोर्ड

boorda	बुरडड	बोर्ड

bord	बरर्ड	बोर्ड

borda	बोर्ड	बोर्ड

boardchya	बोराडच्या	बोर्डच्या

bordchya	बोराडच्या	बोर्डच्या

boardachi	बोरददाची	बोर्डाची

bordachee	बोरदडाची	बोर्डाची

boardache	बोरडडाचे	बोर्डाचे

bordache	बोरददाचे	बोर्डाचे

boardachya	बोरडदाच्या	बोर्डाच्या

bordachya	बोदडडाच्या	बोर्डाच्या

boardateel	बोरदडातील	बोर्डातील

boardatil	बोरदडातील	बोर्डातील

bordateel	बोरददातील	बोर्डातील

boardane	बॉरडडाने	बोर्डाने

bordane	बोरडडाने	बोर्डाने

bolaka	बोलका	बोलका

bolka	बोलका	बोलका

bolanyachee	बोलण्याची	बोलण्याची

bolanyachi	बोलण्याची	बोलण्याची

bolanyache	बोलण्याचे	बोलण्याचे

bolanyachya	बोलण्याच्या	बोलण्याच्या

bolanyatoon	बोलण्यातून	बोलण्यातून

bolanyatun	बोलण्यातून	बोलण्यातून

bolanyamule	बोलण्यामुळे	बोलण्यामुळे

bolanyasathee	बोलण्यासाठी	बोलण्यासाठी

bolanyasathi	बोलण्यासाठी	बोलण्यासाठी

boling	बोलिंग	बोलिंग

bowling	बॉवंंग	बोलिंग

braun	ब्राणन	ब्राऊन

brown	ब्रॉवन	ब्राऊन

braahman	ब्रहहममा	ब्राह्मण

brahman	ब्रहहममण	ब्राह्मण

brahmana	ब्रहहममा	ब्राह्मण

bramhan	ब्रहह्मण	ब्राह्मण

brahmanancha	ब्राम्माांचा	ब्राह्मणांचा

bramhanancha	ब्रहम्मनांचा	ब्राह्मणांचा

brahmananche	ब्राम्माांची	ब्राह्मणांचे

bramhananche	ब्राम्मणांची	ब्राह्मणांचे

brahmanache	ब्राह्मणाची	ब्राह्मणाचे

bramhanache	ब्राम्मााची	ब्राह्मणाचे

brahmanachya	ब्राम्मााच्या	ब्राह्मणाच्या

bramhanachya	ब्रहम्मााच्या	ब्राह्मणाच्या

brahmanat	ब्रहहममणात	ब्राह्मणात

bramhanat	ब्रहम्मणात	ब्राह्मणात

brahmanala	ब्रहह्मणाला	ब्राह्मणाला

bramhanala	ब्रहम्मणाला	ब्राह्मणाला

brahmanee	ब्रहह्मणी	ब्राह्मणी

bramhani	ब्रहम्मणी	ब्राह्मणी

britainche	ब्रिटिचे	ब्रिटनचे

britanache	ब्रिटााे	ब्रिटनचे

britainchya	ब्रिटाच्या	ब्रिटनच्या

britanachya	ब्रिटाा्या	ब्रिटनच्या

britainmadhil	ब्रिटििधील	ब्रिटनमधील

britanamadheel	ब्रिटााधील	ब्रिटनमधील

britanamdheel	ब्रिटााधील	ब्रिटनमधील

britainmadhye	ब्रिटािध्ये	ब्रिटनमध्ये

britanamadhye	ब्रिटााध्ये	ब्रिटनमध्ये

briitanii	ब्रिटाी	ब्रिटनी

briittany	ब्रिटाी	ब्रिटनी

britani	ब्रिटाी	ब्रिटनी

brittani	ब्रिटाा	ब्रिटनी

brittany	ब्रिटट्	ब्रिटनी

blaad	ब्ला	ब्लड

blad	ब्लॅ	ब्लड

blood	ब्लू	ब्लड

blud	ब्लू	ब्लड

blacks	ब्कॉक्स	ब्लॉक्स

blaks	ब्लॉक्स	ब्लॉक्स

blaqs	ब्लॉक्स	ब्लॉक्स

blocks	ब्लॉक्स	ब्लॉक्स

blocqs	ब्लॉक्स	ब्लॉक्स

bhangarat	भंगररात	भंगारात

bhaktibhaav	भक्तिभाव	भक्तिभाव

bhaktibhav	भक्तिभाव	भक्तिभाव

bhaksh	भक्ष	भक्ष

bhaksha	भक्ष	भक्ष

bhakshak	भक्षक	भक्षक

bhagavantanchee	भगवातांची	भगवंतांची

bhagvantanchi	भावातांची	भगवंतांची

bhagwantanchi	भावातांची	भगवंतांची

bhagavantache	भगवातचचे	भगवंताचे

bhagvantache	भगवातचचे	भगवंताचे

bhagwantache	भगवाताचे	भगवंताचे

bhageeni	भाीनी	भगिनी

bhaginee	भािनी	भगिनी

bhagini	भािनी	भगिनी

bhanage	भागे	भणगे

bhange	भागे	भणगे

bhangey	भागे	भणगे

bhannge	भांा	भणगे

bhadrakaali	भा्रकाली	भद्रकाली

bhadrakali	भाररकाळी	भद्रकाली

bhadra	भारर	भद्रा

bhadraa	भारर	भद्रा

bharavite	भरविते	भरविते

bharvite	भरविते	भरविते

bharavila	भरविला	भरविला

bharvila	भरविला	भरविला

bharavilee	भरविली	भरविली

bharvili	भरविली	भरविली

bhalateekadech	भााीकडचच	भलतीकडेच

bhalteekadech	भातीकडेक	भलतीकडेच

bhaltikadech	भातीकडचच	भलतीकडेच

bhavan	भान	भवन

bhavanachya	भानाच्या	भवनाच्या

bhavanat	भानात	भवनात

bhavanateel	भानातील	भवनातील

bhavanatil	भानातील	भवनातील

bhavaneecha	भाननीचा	भवानीचा

bhavanicha	भाननीचा	भवानीचा

bhasin	भाीन	भसीन

bhandanat	भांडणात	भांडणात

bhandnat	भांडणात	भांडणात

bhandi	भांडी	भांडीं

bhandin	भांडिण	भांडीं

bhaubeej	भाबबीज	भाऊबीज

bhaubij	भाबबीज	भाऊबीज

bhauubij	भाऊबीज	भाऊबीज

bhaajyanche	भाज्यांचे	भाज्यांचे

bhajyanche	भाज्यांचे	भाज्यांचे

bhatiya	भातीया	भाटिया

bhade	भाडे	भाडे

bhanushali	भाऊुषाली	भानुशाली

bharatasah	भारतासह	भारतासह

bhashyakar	भाष्यकरर	भाष्यकार

bhaskarrao	भास्करााव	भास्करराव

bhingaree	भिंगरी	भिंगरी

bhingari	भिंगाी	भिंगरी

bhingri	भिंग्ी	भिंगरी

bhikkhu	भिक्कू	भिक्खु

bhijat	भिजत	भिजत

bhijlee	भिजली	भिजली

bhijli	भिजीी	भिजली

bhijavoon	भीजवून	भिजवून

bhijvoon	भिजवून	भिजवून

bhijvun	भिजवून	भिजवून

bhivandeet	भिवंदीत	भिवंडीत

bhivandit	भिवंदित	भिवंडीत

bhiwandit	भिवंदित	भिवंडीत

bheeteene	भितीने	भीतीने

bheetine	भितीणे	भीतीने

bhitine	भितीने	भीतीने

bheetimule	भीतिमुळे	भीतीमुळे

bhiteemule	भितीमुळे	भीतीमुळे

bhitimule	भितिमुळे	भीतीमुळे

bhujang	भुजंग	भुजंग

bhurdand	भुदददंड	भुर्दंड

bhurdanda	भुदददाड	भुर्दंड

bhuvaya	भुवाा	भुवया

bhookamp	भूकमप	भूकंप

bhookanp	भूकाप	भूकंप

bhukamp	भुकमप	भूकंप

bhookampapravan	भूक्प््रमा	भूकंपप्रवण

bhukamppravan	भुकपप््रवण	भूकंपप्रवण

bhukanpapravan	भूकापा्रवा	भूकंपप्रवण

bhookampache	भूकमपाचे	भूकंपाचे

bhookanpache	भूकापाचे	भूकंपाचे

bhukampache	भुममपाचे	भूकंपाचे

bhookampat	भूकमपतत	भूकंपात

bhukampaat	भुकमपात	भूकंपात

bhookampanantar	भूममपूनंतर	भूकंपानंतर

bhookanpannatar	भूकापननंतर	भूकंपानंतर

bhukampanantar	भुमापानंतर	भूकंपानंतर

bhookampane	भूममपुने	भूकंपाने

bhookanpane	भूकापणने	भूकंपाने

bhukampane	भुममपुने	भूकंपाने

bhootakalat	भूतकालात	भूतकाळात

bhootkalaat	भूतकालात	भूतकाळात

bhootkalat	भूतकालात	भूतकाळात

bhootakalateel	भूतकालीतील	भूतकाळातील

bhootkalateel	भूतकालातील	भूतकाळातील

bhoodal	भोडल	भूदल

bhudal	भुडल	भूदल

bhoomiheen	भूमीहीन	भूमिहीन

bhoosthir	भूष्तिर	भूस्थिर

bhusthir	भूष्तिर	भूस्थिर

bheteechya	भेटीच्या	भेटीच्या

bhetichya	भेटीच्या	भेटीच्या

bheteet	भेटीत	भेटीत

bhetit	भेतीत	भेटीत

bheteela	भेटेला	भेटीला

bhetila	भेटीला	भेटीला

bheteesathee	भेटेसाठी	भेटीसाठी

bhetisathi	भेटेसाठी	भेटीसाठी

bhedabhav	भेडााव	भेदभाव

bhedbhav	भेळभाव	भेदभाव

bhokare	भोकरे	भोकरे

bhokre	भोकरे	भोकरे

bhogavati	भोगववती	भोगावती

bhogawati	भोगववती	भोगावती

bhogeeley	भोगेले	भोगिले

bhogile	भोगीले	भोगिले

bhogiley	भोगीले	भोगिले

bhograj	भोगराग	भोजराज

bhojraaj	भोजराज	भोजराज

bhojraj	भोजराज	भोजराज

mangadyaan	मंगळ्ान	मंगळयान

mangalyan	मंगल्ान	मंगळयान

mangdyaan	मंगळ्ान	मंगळयान

mangalagauree	मंगळागारी	मंगळागौरी

mangalagauri	मंगळागौरी	मंगळागौरी

mangdagauree	मंगळगगारी	मंगळागौरी

mangdagauri	मंगळगगौरी	मंगळागौरी

manjoor	मंजूर	मंजुर

manjur	मंजूर	मंजुर

mandirahi	मंदिरही	मंदिरही

mandirache	मंदिराचचे	मंदिरांचा

mandirancha	मंदिरांचा	मंदिरांचा

mandirachi	मंदिराचची	मंदिरांची

mandiranchi	मंदिरांची	मंदिरांची

mandirant	मंदिरांत	मंदिरांत

mandirana	मंदिराणना	मंदिरांना

mandiranna	मंदिरांना	मंदिरांना

mandiranvar	मंडिरांवर	मंदिरांवर

mandirachi	मंदिराची	मंदिराची

mandirache	मंदिराचे	मंदिराचे

mandiravar	मंडिरावर	मंदिरावर

mandiravareel	मंडिरावरील	मंदिरावरील

mandiravaril	मंदिरावरील	मंदिरावरील

mandiravishayi	मंदिरवविषयी	मंदिराविषयी

mandiravishyi	मंदिराविषयी	मंदिराविषयी

mandiras	मंडिरास	मंदिरास

mandiri	मंदिरी	मंदिरी

majalyavar	मजल्यावर	मजल्यावर

majlyavar	मज््यावर	मजल्यावर

majuranchya	मजुरांच्या	मजुरांच्या

majuranna	मजुरांना	मजुरांना

majuranvar	मजुरांवर	मजुरांवर

majjav	मजाजवव	मज्जाव

matacha	मताचा	मताचा

matadhikya	मतधधिक्य	मताधिक्य

matadhikyane	मतधधिक्याने	मताधिक्याने

matanusar	माानुसार	मतानुसार

madatahi	मदताी	मदतही

madathee	मदाीी	मदतही

madathi	मातीी	मदतही

maneesha	मणीशा	मनीषा

manisha	मनिशा	मनीषा

manogat	माोगत	मनोगत

manoget	माोगत	मनोगत

maratha	मराठ	मराठा

maretha	माेठ	मराठा

maratheet	मराठीत	मराठीत

marathit	मराठीत	मराठीत

marathiteet	मराठितीी	मराठीत

marathitit	मराठिती	मराठीत

maratheetale	मराठीताा	मराठीतले

marathitale	मराठीतले	मराठीतले

marathitaley	मराठीतले	मराठीतले

maryadeche	मा्यादेची	मर्यादेचे

maryademule	मा्यादेमुळे	मर्यादेमुळे

maalaya	मााया	मलाया

malaaya	मलाया	मलाया

malaya	मलाया	मलाया

maltipal	मा्तिपा	मल्टिपल

multiple	मूुतिप्	मल्टिपल

malhararao	मलहहरररोव	मल्हारराव

malhararav	मलहहररराव	मल्हारराव

malharrao	मलहहररा	मल्हारराव

malhararavannee	मलाहरराावणंनी	मल्हाररावांनी

malhararavanni	मलाहरराांनंनी	मल्हाररावांनी

malharraonni	मलाहरराांनननी	मल्हाररावांनी

malhotra	मलोहोटरर	मल्होत्रा

malamala	मलाल	मळमळ

malmal	मळ्ल	मळमळ

maval	मााल	मवाळ

masarum	मसरूम	मशरूम

masharum	माे्म	मशरूम

masharuum	मारूम	मशरूम

mashharum	माे्म	मशरूम

mushhroom	मुु्म	मशरूम

mushraam	मु््म	मशरूम

mushroom	मु््म	मशरूम

mushrum	मु््म	मशरूम

mushruum	मु्ूम	मशरूम

musroom	मु््म	मशरूम

muushroom	मु्ूम	मशरूम

machine	माीन	मशिन

mashin	माीन	मशिन

mast	मस्त	मस्ट

must	मु्ट	मस्ट

mahant	महात	महंत

mahat	महतत	महंत

mahamad	महममद	महंमद

mahanmad	महामद	महंमद

mahanmd	महममद	महंमद

mahmad	महममद	महंमद

mahapurush	महापुरुष	महापुरुष

mahapurushaanchi	महापूराषांची	महापुरुषांची

mahapurushanchee	महापुराषांची	महापुरुषांची

mahapurushanchi	महापुराषांची	महापुरुषांची

mahapurushanchya	महापुराषांच्या	महापुरुषांच्या

mahapurushacha	महापुराषाचाया	महापुरुषाच्या

mahapurushachya	महापुराषाच्या	महापुरुषाच्या

mahaprasadaache	महापारसादाचे	महाप्रसादाचे

mahaprasadache	महाप्रसादचचे	महाप्रसादाचे

mahapran	महाप्रान	महाप्राण

mahabalee	महाबाी	महाबली

mahabali	महाबाी	महाबली

mahaaraashhtra	महाराष्ट्र	महाराष्ट्र

mahaaraashtra	महाराष्ट्र	महाराष्ट्र

mahaaraastra	महारास्ट्र	महाराष्ट्र

maharashhtra	महारषष्ट्र	महाराष्ट्र

maharashtra	महारषष्ट्र	महाराष्ट्र

maharastra	महारसस्ट्र	महाराष्ट्र

maharashtrachya	महाराष्ट्राच्या	महाराष्ट्राच्या

maharashtrat	महारषष्ट्रात	महाराष्ट्रात

maharashtrapasoon	महारषष्ट्रापासून	महाराष्ट्रापासून

maharashtrapasun	महाराष्ट्रापासून	महाराष्ट्रापासून

maharashtrasaathi	महाराष्ट्रासाठी	महाराष्ट्रासाठी

maharashtrasathi	महारशष्ट्रासाठी	महाराष्ट्रासाठी

maharashtreey	महररषष्ट्रीय	महाराष्ट्रीय

maharashtriy	महारषष्ट्रीय	महाराष्ट्रीय

maharashtriya	महाराष्ट्रीय	महाराष्ट्रीय

maharudra	महारुद्र	महारुद्रा

mahasfot	महसस्फोट	महास्फोट

mahasphot	महससोफोट	महास्फोट

manjarekar	मंंजेेकर	मांजरेकर

manjrekar	मंंगरेकर	मांजरेकर

maandkey	मांडके	मांडके

mandake	मंंडके	मांडके

mandkay	मंंडके	मांडके

mandkey	मांडके	मांडके

magachi	मागाी	मागची

magchi	मागची	मागची

maagnyachi	मागण्याची	मागण्याची

maganyachi	मागण्याची	मागण्याची

magnyachi	मागण्याची	मागण्याची

maganyat	मागण्यात	मागण्यात

magnyat	मॅगण्यात	मागण्यात

maganyas	मागण्यास	मागण्यास

magnyas	मॅगण्यास	मागण्यास

maganyasathi	मागण्यासाठी	मागण्यासाठी

magnyasathi	मागण्यासाठी	मागण्यासाठी

magasvargiy	मागससवर्गिय	मागासवर्गीय

magasvargiya	मागससवर्गीय	मागासवर्गीय

magasvargiyachya	मागासवर्गिचाचच्या	मागासवर्गीयांच्या

magasvargiyanchya	मागासवि्गिंांच्या	मागासवर्गीयांच्या

magasvargiyansathi	मागासवि्सिससससाठी	मागासवर्गीयांसाठी

magomag	मागोमगग	मागोमाग

magh	मघघ	माघ

machikade	माचिकडे	माचीकडे

machichya	मचचीच्या	माचीच्या

machila	माचीला	माचीला

machivar	माचीवर	माचीवरील

machivaril	मॉच्वरील	माचीवरील

matunga	मातुंग	माटुंगा

maatecha	मातेचा	मातेचा

matecha	मततेचा	मातेचा

maatechi	मततेची	मातेची

matechi	मततेची	मातेची

matha	मठथ	माथा

madagascar	मडडगगससचकर	मादागास्कर

madagaskar	मददगगससककर	मादागास्कर

madagaskara	मददगगससररर	मादागास्कर

madagasqar	मडडगगससककर	मादागास्कर

madagasqara	मदडगगससरकर	मादागास्कर

maargika	मार्गिक	मार्गिका

margika	मार्गिक	मार्गिका

maldiv	माळदीव	मालदीव

maldive	माळदीवे	मालदीव

maldivchya	मालदीवच्या	मालदीवच्या

malad	मललाड	मालाड

malasathi	मललससाठी	मालासाठी

maalta	मालतटा	माल्टा

maaltaa	मालतटा	माल्टा

malta	मालतटा	माल्टा

maltaa	मललतटा	माल्टा

maava	मावा	मावा

mava	मावा	मावा

maasaymaari	मासयमारी	मासेमारी

masaymaari	माययमारी	मासेमारी

masemari	मेसेमररी	मासेमारी

maasaymarichey	मासामारिये	मासेमारीचे

masemariche	मेसेमारीचे	मासेमारीचे

masemarichey	मेसेमररिचे	मासेमारीचे

maasemarichya	मासेमिरीच्या	मासेमारीच्या

masaymarichya	मससामाऱीय्या	मासेमारीच्या

masemarichya	मेसेमररीच्या	मासेमारीच्या

maasaymaariver	मासयमररेवर	मासेमारीवर

masaymaariver	माययमार्वर	मासेमारीवर

masemarivar	मेसेमार्वर	मासेमारीवर

maashtar	माष्टर	मास्टर

maashter	माष्तर	मास्टर

maastar	मसस्टर	मास्टर

maaster	मास्टर	मास्टर

mashtara	माष्टर	मास्टर

mashter	माष्टर	मास्टर

mastar	मसस्टर	मास्टर

mastara	मसस्टर	मास्टर

master	मसस्टर	मास्टर

mashtarsh	माष्टर्स	मास्टर्स

mashtarsha	माष्तर्ष	मास्टर्स

mashtersh	माष्ट््स	मास्टर्स

mastars	मसस्टर्स	मास्टर्स

mastarsa	मसस्टर्स	मास्टर्स

masters	मॅस्टर्स	मास्टर्स

mickey	मिक्	मिकी

micky	मिकी	मिकी

miikee	मिकी	मिकी

miikii	मिकी	मिकी

mikee	मिकी	मिकी

miki	मिकी	मिकी

mikii	मिकी	मिकी

miqee	मिकी	मिकी

miqi	मिकी	मिकी

mit	मित	मित

mitt	मित्	मित

mithila	मिथाला	मिथिला

miravanukis	मिरवणुकीस	मिरवणुकीस

miravnukis	मिर्णुकीस	मिरवणुकीस

mirasdar	मिरससद	मिरासदार

mirzapur	मिर्जापूर	मिर्झापूर

milian	मिलिएन	मिलियन

milion	मिलिनन	मिलियन

miliyan	मिलियन	मिलियन

miliyon	मिलिनन	मिलियन

millan	मिल्ंन	मिलियन

millian	मिलिलन	मिलियन

million	मिलिनन	मिलियन

milliyan	मिलिला	मिलियन

milliyon	मिलिनन	मिलियन

midvinaari	मिळविणारी	मिळविणारी

midvinari	मिळविणारी	मिळविणारी

milavinari	मिळविणारी	मिळविणारी

misadtaat	मिसळतात	मिसळतात

misalatat	मिसळतात	मिसळतात

misaltat	मिसळतात	मिसळतात

meetarache	मितरचे	मीटरचे

meetarche	मितरचे	मीटरचे

meterche	मिटरचे	मीटरचे

meetarachya	मितरच्या	मीटरच्या

meetarchya	मिटरच्या	मीटरच्या

meterchya	मेटरच्या	मीटरच्या

meetaramadhye	मीतााध्ये	मीटरमध्ये

meetarmadhye	मितर्ध्ये	मीटरमध्ये

metermadhye	मेटरमध्ये	मीटरमध्ये

meediyavar	मिदियावर	मीडियावर

meerabai	मेरबबाई	मीराबाई

mirabai	मिरबबाई	मीराबाई

mungya	मुंग्या	मुंग्या

mukkam	मुक्कमम	मुक्काम

mukkamat	मुक्कममात	मुक्कामात

mukkamee	मुक्मममी	मुक्कामी

mukkami	मुक्मीमी	मुक्कामी

mukti	मुक्ती	मुक्ति

mooni	मूनी	मुनी

moonii	मोनी	मुनी

munee	मुनी	मुनी

muni	म्नी	मुनी

munii	मुनी	मुनी

muneennee	मुन्ननी	मुनींनी

muninni	मुनींनी	मुनींनी

munnabhai	मुन्नाभाई	मुन्नाभाई

murtee	मूर्ती	मुर्ती

murti	मूर्ती	मुर्ती

murteechee	मूर्तीची	मुर्तीची

murtichi	मूर्तिची	मुर्तीची

mul	मूळ	मुलं

mulam	मुला	मुलं

mulaant	मुलांत	मुलांत

mulant	मुलांत	मुलांत

mulanpaikee	मुलंंपैकी	मुलांपैकी

mulanpaiki	मुलांपैकी	मुलांपैकी

mulansathee	मुलांसाठी	मुलांसाठी

mulansathi	मुलांसाठी	मुलांसाठी

mulakhatee	मुलाखती	मुलाखती

mulakhati	मुलाखती	मुलाखती

mulakhateechya	मुलाखतीच्या	मुलाखतीच्या

mulakhatichya	मुलाखतीच्या	मुलाखतीच्या

mulakhateehee	मुलाखतहही	मुलाखतीही

mulakhatihi	मुलाखतीही	मुलाखतीही

mulukh	मुलुख	मुलुख

mudaskat	मुदास्त	मुळासकट

mulasakat	मुलासकट	मुळासकट

mooth	मूठ	मूठ

muth	मुठ	मूठ

moorkh	मूर्ख	मूर्ख

murkh	मुर्ख	मूर्ख

moorcha	मूर्चाया	मूर्च्छा

moorchchha	मूरचच	मूर्च्छा

murcha	मूर्च	मूर्च्छा

murchha	मूर्च	मूर्च्छा

marathon	मररेथॉन	मॅरॅथॉन

mendu	मेंडू	मेंदू

menducha	मेंडूचा	मेंदूचा

menduche	मेंडूचे	मेंदूचे

menduchya	मेंदूच्या	मेंदूच्या

mendut	मेंडूत	मेंदूत

menduteel	मेंड्तील	मेंदूतील

mendutil	मेंद्तील	मेंदूतील

mendumadhye	मेंदुमध्ये	मेंदूमध्ये

mendula	मेंडूल	मेंदूला

make	माक	मेक

meeksikan	मेक्सिकन	मेक्सिकन

meexican	मेक्सिनन	मेक्सिकन

meexikan	मेक्सिकन	मेक्सिकन

meksican	मेक्सिकन	मेक्सिकन

meksikan	मेक्सिकन	मेक्सिकन

meqsiqan	मेक्सिकन	मेक्सिकन

mexican	मेक्सिकन	मेक्सिकन

mexikan	मेक्सिकन	मेक्सिकन

mexiqan	मेक्सिकन	मेक्सिकन

megan	मेगन	मेगन

mait	मात	मेट

mate	मात	मेट

matee	माती	मेट

meet	मिट	मेट

met	मेत	मेट

mete	मेते	मेट

maits	माट्स	मेट्स

meetas	मिट्स	मेट्स

meets	मिट्स	मेट्स

metas	मॅटास	मेट्स

mets	मेट्स	मेट्स

main	मेन	मेण

men	मेन	मेण

menachay	मेनाचे	मेणाचे

menache	मेनाचे	मेणाचे

mael	माल	मेल

mail	मैल	मेल

male	माल	मेल

malee	माली	मेल

meel	मेल	मेल

meela	मेला	मेल

mel	मेल	मेल

mela	मेला	मेल

mele	मेले	मेले

mehanati	मेहणती	मेहनती

mehanti	मेहतती	मेहनती

mehnati	मेहणाी	मेहनती

mehsaana	मेहसाना	मेहसाणा

mehsana	मेहसनना	मेहसाणा

maidanacha	मैदानाचा	मैदानाचा

maidanat	मैदानात	मैदानात

maidanateel	मैदननातील	मैदानातील

maidanatil	मैदानातील	मैदानातील

maidane	मैदाने	मैदाने

motha	मोठा	मोठं

moteeram	मोटरराम	मोतीराम

motiram	मॉट्राम	मोतीराम

moteelal	मोतीलाल	मोतीलाल

motilal	मोतिलाल	मोतीलाल

mobail	मोबाईल	मोबाइल

mobel	मोबेलल	मोबाइल

mobile	मोबाईल	मोबाइल

moobail	मोबाईल	मोबाइल

moobile	मोबाईल	मोबाइल

mobilechi	मोबाईलीी	मोबाइलची

momeen	मॉनिन	मोमीन

momin	मोमिन	मोमीन

moore	मूर	मोरे

moorey	मूर	मोरे

more	मोर	मोरे

moree	मोरी	मोरे

moreey	मोर	मोरे

morei	मोर	मोरे

morey	मोर	मोरे

moreni	मोरिननी	मोरेंनी

morennee	मॉरेननी	मोरेंनी

morenni	मॉरेंनी	मोरेंनी

mooresbi	मूरेस्बी	मोरेस्बी

mooresbie	मूरेसबबी	मोरेस्बी

mooresby	मूरेसिसी	मोरेस्बी

moreesbi	मोरेशिबी	मोरेस्बी

moreesbiee	मोरिसबबी	मोरेस्बी

moreesby	मोरिसिस	मोरेस्बी

moresbi	मोरेसिबी	मोरेस्बी

moresbie	मोरेसिबी	मोरेस्बी

moresbii	मोरेस्बी	मोरेस्बी

moresbiie	मोरोसबबी	मोरेस्बी

moresby	मोरासिसी	मोरेस्बी

moorle	मूरलल	मोर्ले

moorley	मूरलली	मोर्ले

morle	मोरलल	मोर्ले

morlee	मोरलली	मोर्ले

morleey	मॉरलली	मोर्ले

morlei	मोरलली	मोर्ले

morley	मॉरलली	मोर्ले

mosamee	मोसाी	मोसमी

mosami	मोसाी	मोसमी

mohimecha	मोहिमीचा	मोहिमेचा

mohimechya	मोहिमीच्या	मोहिमेच्या

mohimet	मोहिमेत	मोहिमेत

mohimeteel	मोहिमीतील	मोहिमेतील

mohimetil	मोहिमेतील	मोहिमेतील

mohimedaramyan	मोहिमेरााजयान	मोहिमेदरम्यान

mohimedarmyan	मोहिमेर्ा्यान	मोहिमेदरम्यान

mohimemadhye	मोहिमेमध्ये	मोहिमेमध्ये

mohimes	मोहिम्	मोहिमेस

maulyavaan	मौल्यवान	मौल्यवान

maulyavan	मौल्यवान	मौल्यवान

moulyavan	मूल्यवान	मौल्यवान

myaanmaar	मायानारर	म्यानमार

myanamara	म्यानारराा	म्यानमार

myanmar	म्याममरर	म्यानमार

myanmaarchya	मायामाररा्या	म्यानमारच्या

myanmarchya	मायामाररा्या	म्यानमारच्या

myanmaarmadhye	मायानमाराध्ये	म्यानमारमध्ये

myanmarmadhye	मायानााराध्ये	म्यानमारमध्ये

mhanatat	म्हणतात	म्हणतात

mhais	म्हैस	म्हैस

yayaati	यााती	ययाति

yayati	ययाती	ययाति

yashamuday	यशामोळे	यशामुळे

yashamule	यशामुळे	यशामुळे

yanchyakadoon	यांच्याकडून	यांच्याकडून

yanchyakadun	यांच्याकडून	यांच्याकडून

yanchyakadoonahi	यांच्याकडूनीी	यांच्याकडूनही

yanchyakadunahi	यांच्याकाूनीी	यांच्याकडूनही

yanchyakadunhi	यांच्याकडूनीी	यांच्याकडूनही

yanchyakade	यांच्याकडे	यांच्याकडे

yanchyach	यांच्याच	यांच्याच

yanchyat	यांच्यात	यांच्यात

yanchyadaramyan	यांच्यादरम्यान	यांच्यादरम्यान

yanchyadarmyan	यांच्यादरम्यान	यांच्यादरम्यान

yanchyanantar	यांच्यानंतर	यांच्यानंतर

yanchyapasoon	यांच्यापासून	यांच्यापासून

yanchyapasun	यांच्यापासून	यांच्यापासून

yanchyapeksha	यांच्यापेक्षा	यांच्यापेक्षा

yanchyapramanech	यांच्यापारमांेच	यांच्याप्रमाणेच

yanchyabaddal	यांच्याबद्दल	यांच्याबद्दल

yanchyamadhye	यांच्यामध्ये	यांच्यामध्ये

yanchyamule	यांच्यामुळे	यांच्यामुळे

yanchyasathee	यांच्यासाठी	यांच्यासाठी

yanchyasathi	यांच्यासाठी	यांच्यासाठी

yanchyahee	यांच्याही	यांच्याही

yanchyahi	यांच्याही	यांच्याही

yanpasoon	यांपासून	यांपासून

yanpasun	यानपासून	यांपासून

yans	यांस	यांस

yaantargat	यांंतर्ग	याअंतर्गत

yanantargat	याननतर्गत	याअंतर्गत

yakade	याकडे	याकडे

yacha	याचा	याचा

yachach	याचाच	याचाच

yadnyik	याज्ञिक	याज्ञिक

yagyik	याजिञिक	याज्ञिक

yadivashee	यादिवाी	यादिवशी

yadivashi	यादिवाी	यादिवशी

yaprakaarchay	याप्रकाराे	याप्रकारचे

yaprakaarche	याप्रकारचे	याप्रकारचे

yaprakarche	याप्रकारचे	याप्रकारचे

yaprakaarchya	याप्रकारा्या	याप्रकारच्या

yaprakarchya	याप्रकारच्या	याप्रकारच्या

yaprakaray	याप्रकारय	याप्रकारे

yaprakare	याप्रकारे	याप्रकारे

yaas	यास	यास

yas	यास	यास

yaasi	यासी	यासी

yasee	यासी	यासी

yasi	यासी	यासी

euclid	युलललिड	युक्लीड

eucliid	युल्डीड	युक्लीड

yuklid	युक्लीड	युक्लीड

yukliid	युक्लीड	युक्लीड

yuqlid	युकललीड	युक्लीड

unus	उुन्स	युनूस

uunuus	उून	युनूस

yaanus	यानुस	युनूस

yaunis	यानिस	युनूस

yoonus	युनुस	युनूस

yoonuus	युनुस	युनूस

younis	योनेस	युनूस

youunis	योनेस	युनूस

yunoos	युनोस	युनूस

yunus	युनुस	युनूस

yuunis	युनिस	युनूस

yuunus	युनुस	युनूस

yuunuus	युऊुस	युनूस

yeiparyant	येपपर्टंत	येईपर्यंत

yeja	येजा	येजा

yenay	येने	येणे

yene	येने	येणे

yethe	येथे	येथे

yethey	येथे	येथे

yethahee	येथहही	येथेही

yethayhi	येथहही	येथेही

yethehi	येथेही	येथेही

yeddoor	एेददडार	येळ्ळूर

yellur	येलरररर	येळ्ळूर

yeshil	येशील	येशिल

yojataat	योजतात	योजतात

yojatat	योजतात	योजतात

yojtaat	योजतात	योजतात

ranganath	रंगनाथ	रंगनाथ

rangavalele	रागवलेले	रंगवलेले

rangavalelya	रंगवलेल्या	रंगवलेल्या

rakami	रकमी	रकमी

rakmee	रक्ी	रकमी

raktadaan	रक्तदान	रक्तदान

raktadan	रक्तदान	रक्तदान

rakshanachi	रक्षणाची	रक्षणाची

raksha	रा्षा	रक्षा

rakshabandhan	रक्षबबंधन	रक्षाबंधन

raghupatee	रघुपती	रघुपती

raghupati	रघुपती	रघुपती

ran	रा	रण

ranathambor	रणााबरर	रणथंबोर

ranthambor	रं्बबरर	रणथंबोर

ranbhoomeevar	राभूमीवर	रणभूमीवर

ranbhoomivar	राभूमीवर	रणभूमीवर

ranbhumivar	रंभूमीवर	रणभूमीवर

raya	राा	रया

ravi	रवि	रवी

ravii	रवि	रवी

rawi	रवि	रवी

ravind	रविनद	रवींद

rashhiyana	रािया	रशियन

rashiyan	राीया	रशियन

rashiyana	रािया	रशियन

rasiyana	रािया	रशियन

ruchian	रुिचन	रशियन

rushhian	ऋुियन	रशियन

rushian	ऋुीयन	रशियन

rusian	रसियन	रशियन

russian	रसियन	रशियन

rashhia	राीया	रशिया

rashhiaa	राीया	रशिया

rashhiya	राीया	रशिया

rashhiyaa	राीया	रशिया

rashia	रशीया	रशिया

rashiaa	रशीया	रशिया

rashiya	राीया	रशिया

rashiyaa	राीया	रशिया

rasia	रसिया	रशिया

rasiaa	रशिया	रशिया

rasiya	रसिया	रशिया

rasiyaa	रसिया	रशिया

rushshia	ऋूीषा	रशिया

russia	रसीला	रशिया

rashiyat	राियात	रशियात

russiat	रसिषात	रशियात

rashiyavar	राियावर	रशियावर

russiavar	ससीदावर	रशियावर

rasal	रसलळ	रसाळ

rassa	रसास	रस्सा

rakheev	राखीव	राखीव

rakhiv	राखीव	राखीव

rajkiy	राजकीय	राजकिय

rajkiya	राजकीया	राजकिय

rajan	राजा	राजन

rajnath	राजनाथ	राजनाथ

rajasthanchee	रासस्थांची	राजस्थानची

rajasthanchi	राजसाथांाी	राजस्थानची

rajasthanmadhye	राजसंथांमध्ये	राजस्थानमध्ये

rajasthanat	राजसाथानात	राजस्थानात

rajasthanatoon	राससाथानातून	राजस्थानातून

rajasthanatun	राससाथानातून	राजस्थानातून

rajasthanee	राजसाथानी	राजस्थानी

rajasthani	राजसाथानी	राजस्थानी

rajapoor	राजापूर	राजापूर

rajapur	राजापूर	राजापूर

rajoorkar	राजररकर	राजूरकर

rajurkar	राजरर्र	राजूरकर

rajyabhar	राज्यार	राज्यभर

rajyabharat	राज्यभरात	राज्यभरात

rajyabhishekachya	राज्यभभिषाचाच्या	राज्याभिषेकाच्या

rajyabhishekanchya	राज्यभभिषाखां्या	राज्याभिषेकाच्या

rajyabhishekanantar	राज्यभभिषेनननंतर	राज्याभिषेकानंतर

rajyabhishekannantar	राज्यभभिषानांंतर	राज्याभिषेकानंतर

rajyabhishekala	राज्यभभिषेललला	राज्याभिषेकाला

rajyamadhil	राज्यामधील	राज्यामधील

ranichi	रणणीची	राणीची

ranichya	रणणीच्या	राणीच्या

raane	राणे	राने

rane	राणे	राने

ramapura	रामाूर	रामपूर

ramapuura	रामाूर	रामपूर

rampaar	रामपार	रामपूर

rampoor	रामपूर	रामपूर

rampur	रामपूर	रामपूर

rampuur	रामपूर	रामपूर

raalegao	रालेगाव	राळेगाव

radegaav	राडेगाव	राळेगाव

ralegao	रालेगाव	राळेगाव

ralegav	रालेगाव	राळेगाव

rashtray	राष्ट्रयय	राष्ट्रिय

rashtriy	राष्ट्रीय	राष्ट्रिय

rashtriya	राष्ट्रीया	राष्ट्रिय

rahata	रहहता	राहता

rahta	राहता	राहता

rahtaa	रहहता	राहता

rahilya	राहील्या	राहिल्या

rahilyamuday	रहहिल्यामुळ्	राहिल्यामुळे

rahilyamule	राहिय्यामुळे	राहिल्यामुळे

reeka	रेका	रिका

reeqa	रेका	रिका

rica	रीका	रिका

riika	रीका	रिका

rika	रीका	रिका

riqa	रीका	रिका

rikamya	रिकाम्या	रिकाम्या

richards	रिचर्ड	रिचर्डस

reliance	रेलेंन्स	रिलायन्स

relief	रेलेफ	रिलीफ

relieph	रेलीफ	रिलीफ

reliief	रेलेफ	रिलीफ

riiliiph	रिलिफ	रिलीफ

rilif	रिलिफ	रिलीफ

riliph	रिलिफ	रिलीफ

relations	रेलेटन	रिलेशन्स

resource	रिसूर्स	रिसोर्स

rudravatar	रुदररववतरर	रुद्रावतार

rudravtar	रुद्रववतार	रुद्रावतार

rupayanchi	रुपयांची	रुपयांची

rupayanchya	रुपयांच्या	रुपयांच्या

rupyanchya	रुप्ांच्या	रुपयांच्या

rupayant	रुपयांत	रुपयांत

rupyant	रुपयंंत	रुपयांत

rusava	ऋुसवा	रुसवा

rusva	रूस्ा	रुसवा

raani	रानी	रूनी

roonee	रोनी	रूनी

rooney	रोन	रूनी

rooni	रोनी	रूनी

roonii	रोनी	रूनी

runee	रुणी	रूनी

runei	रुनी	रूनी

runey	रुनी	रूनी

runi	रुनी	रूनी

runii	ऋुनी	रूनी

ruuney	रुने	रूनी

ruuni	ऋुनी	रूनी

roopaye	रूपाे	रूपये

rupaye	रुपये	रूपये

rekhataat	रेखाटत	रेखाटतात

rekhatat	रेखाटत	रेखाटतात

rekhatatat	रेखाटतात	रेखाटतात

rekhattat	रेखटटतात	रेखाटतात

reghotya	रेघोट्या	रेघोट्या

raincoat	रेणकोट	रेनकोट

raincoet	रेन्ोट	रेनकोट

raincooat	रेणकोट	रेनकोट

rainkoat	रेणकोट	रेनकोट

rainkoet	राणॉोट	रेनकोट

rainkooat	रेणको	रेनकोट

rainqoat	रेणकोट	रेनकोट

reenakot	रिनाोट	रेनकोट

reencoat	रिन्ाट	रेनकोट

reenkot	रिणॉॉट	रेनकोट

renakoot	रेणाोट	रेनकोट

renakot	रिनाोट	रेनकोट

renaqot	रिणााट	रेनकोट

rencoat	रिण्ाट	रेनकोट

rencoet	रेण्	रेनकोट

rencooat	रेण्ाट	रेनकोट

renkoat	रेणाोट	रेनकोट

renkoot	रेणकोट	रेनकोट

renkot	रेणकोट	रेनकोट

renqot	रेणॉोट	रेनकोट

reverand	रेवरहर्ड	रेव्हरंड

reverend	रेवेहर्ड	रेव्हरंड

revharand	रेहरहर्ड	रेव्हरंड

revhrand	रेहरहर्ड	रेव्हरंड

revrand	रेवरहर्ड	रेव्हरंड

reshamee	रेषाी	रेशमी

reshami	रेषमी	रेशमी

reshmee	रेशमी	रेशमी

reesideent	रेसिंंंट	रेसिडेंट

resident	रेसिंंंट	रेसिडेंट

residentt	रेसिंंटट	रेसिडेंट

rezident	रिझिंंंट	रेसिडेंट

rahan	रहहणन	रेहान

rehan	रहहनण	रेहान

roostoov	र्स्तोव	रोस्तोव

rostov	रोस्टो	रोस्तोव

rostow	रोस्टो	रोस्तोव

rohan	रोहन	रोहन

rohana	रोहन	रोहन

roohan	रोहन	रोहन

roohana	रोहन	रोहन

rohile	रोहिले	रोहिले

rohiley	रोहिले	रोहिले

haars	हाससस	र्हास

hars	हासास	र्हास

has	हासास	र्हास

horse	होहोस	र्हास

laksh	ला्ष	लक्ष

laksha	ला्षा	लक्ष

lakshanancha	लक्ष्ांचा	लक्षणांचा

lakshananchee	लक्षाांची	लक्षणांची

lakshananchi	लक्षाांची	लक्षणांची

lakshananmadhye	लक्षणांमध्ये	लक्षणांमध्ये

lakshahi	लक्षाी	लक्षही

lakshun	लक्षून	लक्षून

lakshminagar	लक्ष्मीनगर	लक्ष्मीनगर

laxminagar	लक्ष्मीनगर	लक्ष्मीनगर

lagatcha	लाााा	लगतचा

lagatche	लात्े	लगतचे

lagatchey	लातचे	लगतचे

laththapana	लठवयपणा	लठ्ठपणा

latthapana	लठ्टााा	लठ्ठपणा

latthpana	ठठ्पपणा	लठ्ठपणा

ladh	ला	लढ

ladha	लढा	लढ

ladhala	लढाा	लढला

ladhla	लढला	लढला

ladhalya	लढल्या	लढल्या

ladhlya	लढल्या	लढल्या

ladhay	लढा	लढे

ladhe	लढे	लढे

lavasa	लाससा	लवासा

lavasaa	लवससा	लवासा

lavh	ला	लव्ह

love	लोेहे	लव्ह

lavhadee	ला्हाडी	लव्हाळी

lavhadi	ल््हाडी	लव्हाळी

lavhali	लालहलळी	लव्हाळी

lashkarache	लश्करचचे	लष्कराचे

lashkarachey	लश्करचचे	लष्कराचे

lashkarachya	लश्करचच्या	लष्कराच्या

lashkaratoon	लश्करातून	लष्करातून

lashkaratun	लश्करातून	लष्करातून

lashkaravar	लश्करावर	लष्करावर

lashkaraver	लश्करववर	लष्करावर

lashkarawer	लश्करावर	लष्करावर

lashkarvar	ला्करववर	लष्करावर

lagato	लागतो	लागतो

lagto	लागतो	लागतो

lagavadicha	लागवाीचा	लागवडीचा

lagvadicha	लगगवडीचा	लागवडीचा

lagavadichi	लागवडीची	लागवडीची

lagvadichi	लगगवाीची	लागवडीची

laatet	लाटेट	लाटेत

latet	लॅटेट	लाटेत

laal	लाळ	लाल

lal	लाळ	लाल

lala	लाला	लाल

laloo	लालू	लालू

laloon	लालूनन	लालू

lavanyacha	लावण्याचा	लावण्याचा

lavanyachs	लावण्यासा	लावण्याचा

lavnyacha	लावण्याचा	लावण्याचा

lavanyachee	लावण्याची	लावण्याची

lavanyachi	लावण्याची	लावण्याची

lavnyachee	लावण्याची	लावण्याची

lavanyachya	लावण्याच्या	लावण्याच्या

lavnyachya	लावण्याच्या	लावण्याच्या

laavnyaat	लावण्यात	लावण्यात

lavanyat	लावण्यात	लावण्यात

lavnyat	लावण्यात	लावण्यात

lavanyasathee	लावण्यासाठी	लावण्यासाठी

lavanyasathi	लावण्यासाठी	लावण्यासाठी

lavnyasathee	लावण्यासाठी	लावण्यासाठी

leenks	लिनक्स	लिंक्स

leenqs	लिनक्स	लिंक्स

liinks	लिंक्स	लिंक्स

lincs	लिनक्स	लिंक्स

links	लिंक्स	लिंक्स

linqs	लिंक्स	लिंक्स

linx	लिंक्स	लिंक्स

lynks	लिंक्स	लिंक्स

lynqs	लिंक्स	लिंक्स

limbale	लिंबलले	लिंबाळे

leara	लीटा	लिरा

leera	लीरा	लिरा

lera	लीरा	लिरा

liira	लीरा	लिरा

lira	लीरा	लिरा

lihaava	लिहावा	लिहावा

lihava	लिहावा	लिहावा

lihito	लिहितो	लिहितो

lay	लय	ले

le	ले	ले

ley	ले	ले

lekh	लेख	लेख

lekhamala	लेखमाला	लेखमाला

lekhmaala	लेखमाला	लेखमाला

lekhmala	लेखमाला	लेखमाला

lekhale	लेखले	लेखले

lekhle	लेखले	लेखले

lekhley	लेखले	लेखले

lekhaanchee	लेखांची	लेखांची

lekhanchi	लेखनंची	लेखांची

lekhanmadhye	लेखांमध्ये	लेखांमध्ये

lekhacha	लेखाचा	लेखाचा

lekhache	लेखाचे	लेखाचे

lekhat	लेखतत	लेखात

lekhateel	लेखातील	लेखातील

lekhatil	लेखातील	लेखातील

lene	लेणे	लेणे

loid	लॉईड	लॉइड

loids	लॉईड	लॉइड

lawyer	लॉयर	लॉयर

loyar	लोयर	लॉयर

las	लसस	लॉस

lass	लसस	लॉस

laus	लौस	लॉस

laush	लूस	लॉस

lauss	लूस	लॉस

los	लोस	लॉस

losh	लोस	लॉस

loshsh	लोस	लॉस

loss	लोस	लॉस

lokakalechhya	लोककलेच्या	लोककलेच्या

lokakalechya	लोककलेच्या	लोककलेच्या

lokkalechya	लोककलेच्या	लोककलेच्या

lokaparampara	लोकपामपरा	लोकपरंपरा

lokparampara	लोकपर्पर	लोकपरंपरा

lokamanasat	लोकमानाात	लोकमानसात

lokmanasat	लोकमानसात	लोकमानसात

local	लोकल	लोकल

lokal	लोकल	लोकल

loocal	लोकल	लोकल

lookal	लुकल	लोकल

loqal	लोकल	लोकल

localne	लोकलणे	लोकलने

lokalane	लोकलणे	लोकलने

loksabhechee	लोकसभीही	लोकसभेची

loksabhechi	लोकसभेची	लोकसभेची

loksabheche	लोकसभेचे	लोकसभेचे

loksabhechey	लोकसभेची	लोकसभेचे

loksabhet	लोकसभेत	लोकसभेत

loksabheteel	लोकसभेतील	लोकसभेतील

loksabhetil	लोकसभेतील	लोकसभेतील

lokanunay	लोकानुने	लोकानुनय

lokanunaya	लोकानुया	लोकानुनय

lokashray	लोकशषररय	लोकाश्रय

lokopayogee	लोकपपैोगी	लोकोपयोगी

lokopayogi	लोकपपैीली	लोकोपयोगी

lokopyogee	लोकपप्ोगी	लोकोपयोगी

lote	लोट	लोटे

loan	लोन	लोण

lon	लोन	लोण

vakilanchya	वििलांच्या	वकिलांच्या

vakilanna	वॉिलांना	वकिलांना

vakilannee	वकिलांनी	वकिलांनी

vakilas	वििलसस	वकिलास

vakr	वा्र	वक्र

vakra	वक्र	वक्र

vajra	वजरर	वज्र

vadhoocha	वाुहा	वधूचा

vadhucha	वाुचा	वधूचा

vadhoochya	वाूच्या	वधूच्या

vadhuchya	वाुच्या	वधूच्या

vanaushadhi	वनुषाी	वनौषधी

vanoushadhi	वनुषाी	वनौषधी

vayat	वयात	वयात

varishtha	वरीष्ठ	वरिष्ठ

varishthankade	वरीष्ठकंकडे	वरिष्ठांकडे

varishthanna	वरीष्ठांना	वरिष्ठांना

vareelpramane	वाीलप्रमाणे	वरीलप्रमाणे

varilpramane	वॉिपप्रमाणे	वरीलप्रमाणे

vargamool	वर्गाूल	वर्गमूळ

vargmool	वर्गुूल	वर्गमूळ

vargmul	वर्गमुल	वर्गमूळ

vartamanpatra	वर्तमंनंतार	वर्तमानपत्र

vartmanpatra	वर्तमंनपत्र	वर्तमानपत्र

vartamanpatrat	वर्तमानपतार	वर्तमानपत्रात

vartmanpatrat	वर्तमंंातार	वर्तमानपत्रात

vartamanpatrateel	वर्तमंनात्तातील	वर्तमानपत्रातील

vartamanpatratil	वर्तमंनात्तातील	वर्तमानपत्रातील

vartmanpatratil	वर्तमांतत्तातील	वर्तमानपत्रातील

vartamanpatratoon	वर्तमानातूरूंून	वर्तमानपत्रातून

vartamanpatratun	वर्तमानंत्रातून	वर्तमानपत्रातून

vartmanpatratun	वर्तमंंात्रात	वर्तमानपत्रातून

varth	वा्थ	वर्थ

worth	वॉ्थ	वर्थ

varld	वॉ्ल	वर्ल्ड

vorld	वॉ्ल्ड	वर्ल्ड

warld	वॉलल	वर्ल्ड

world	वॉ्ल्ड	वर्ल्ड

varshanchee	वर्षांची	वर्षांची

varshanchi	वर्षांची	वर्षांची

varshanteel	वर्षांतील	वर्षांतील

varshantil	वर्षांतील	वर्षांतील

varshannantar	वर्षांनंतर	वर्षांनंतर

varshannatar	वर्षाननरतर	वर्षांनंतर

varshanparyant	वर्षांपर्यंत	वर्षांपर्यंत

varshanpasoon	वर्षांपासून	वर्षांपासून

varshanpasun	वर्षांपासून	वर्षांपासून

varshanpeksha	वर्षांपेक्षा	वर्षांपेक्षा

varshansathee	वर्षांसाठी	वर्षांसाठी

varshansathi	वर्षांसाठी	वर्षांसाठी

varshanhoon	वर्षांहून	वर्षांहून

varshanhun	वर्षांहून	वर्षांहून

varshani	वर्षांी	वर्षानी

varshech	वर्षेच	वर्षेच

varsheparyant	वर्षेपर्यंत	वर्षेपर्यंत

varsheparyanta	वर्षेपर्यंत	वर्षेपर्यंत

valanare	वळणारे	वळणारे

valnare	वळणारे	वळणारे

valane	वाणे	वळणे

valne	वाणे	वळणे

valave	वळववे	वळावे

vasishth	वसिषेठ	वसिष्ठ

vasishtha	वसेष्ठ	वसिष्ठ

vasundhara	वसुंधाा	वसुंधरा

vastutah	वस्तुतह	वस्तुतः

vastutaha	वस्तुता	वस्तुतः

vastuman	वस्तुमान	वस्तुमान

vastoonee	वस्तूननी	वस्तूंनी

vastoonnee	वस्तूंनी	वस्तूंनी

vastoochya	वस्तूच्या	वस्तूच्या

vastuchya	वस्तूच्या	वस्तूच्या

vastoopasoon	वस्तूपासून	वस्तूपासून

vastupasun	वस्तुपासनन	वस्तूपासून

vastoola	वस्तूला	वस्तूला

wastula	वस्तुला	वस्तूला

vastoovar	वस्तूवर	वस्तूवर

vastuvar	वस्तुवर	वस्तूवर

vastraharan	वस्त्रााा	वस्त्रहरण

vaiche	वाईचे	वाईचे

vaiiche	वाईचे	वाईचे

vaiiteel	वैईतील	वाईतील

vaiteel	वैईतील	वाईतील

vaitil	वैईतील	वाईतील

vakprachar	वककपपरराार	वाक्प्रचार

vaganook	वागणूक	वागणूक

vagnook	वाग्ूक	वागणूक

vagnuk	वागणूक	वागणूक

vagato	वागतो	वागतो

vagto	वगगतो	वागतो

vachal	वाचलल	वाचाल

vajantree	वजजनत्री	वाजंत्री

vajantri	वजजनत्री	वाजंत्री

vatave	वाटवे	वाटवे

vatve	वाटवे	वाटवे

vatecha	वाटेचा	वाटेचा

vatetil	वटटेतील	वाटेतील

vaadekar	वाडेकर	वाडेकर

vadekar	वाडेकर	वाडेकर

vadhatach	वाढता	वाढतच

vadhatch	वाढतच	वाढतच

vadhavila	वाढविला	वाढविला

vadhvila	वाढविला	वाढविला

vadyanch	वाद्यांच	वाद्यांचा

vadyancha	वाड्यांचा	वाद्यांचा

vadyanchya	वाड्यांच्या	वाद्यांच्या

vadyanna	वाड्यांना	वाद्यांना

vadyachi	वाड्याची	वाद्याची

vapar	वापा	वापर

vaparata	वापरता	वापरता

vaparta	वापरता	वापरता

vaparache	वापराचे	वापराचे

vaparat	वापरात	वापरात

vaparatoon	वापरातून	वापरातून

vaparatun	वापरातून	वापरातून

vaparane	वापरणने	वापराने

vaaprawar	वापरावर	वापरावर

vaparavar	वापरावर	वापरावर

vaapras	वापरास	वापरास

vaparas	वापरास	वापरास

vaaprasaathi	वापरासाठी	वापरासाठी

vaparasathi	वापरासाठी	वापरासाठी

vaam	वाम	वाम

vam	वाम	वाम

waam	वाम	वाम

vaarna	वार्ा	वारणा

varana	वारणा	वारणा

varna	वरर्ा	वारणा

vurna	वरर्ा	वारणा

warana	वररणा	वारणा

warna	वरर्ा	वारणा

wurna	वरर्ा	वारणा

varyacha	वरर्याचा	वाऱ्याचा

varyachya	वरर्याच्या	वाऱ्याच्या

varyane	वार्याने	वाऱ्याने

varyamule	वरर्यामुळे	वाऱ्यामुळे

valchandnagar	वालचंदाार	वालचंदनगर

walchandnagar	वॉलचंगाार	वालचंदनगर

vasavaroon	वससरवरून	वासावरून

vasavarun	वससरवरून	वासावरून

vasoo	वासू	वासू

vasu	वससू	वासू

vastu	वसस्तू	वास्तु

vahatukichi	वाहतुकीची	वाहतुकीची

vahtukeechee	वाहतुकीची	वाहतुकीची

vahtukichi	वाहतुकीची	वाहतुकीची

vahatukit	वाहतुकीत	वाहतुकीत

vahtukeet	वाहतुकीत	वाहतुकीत

vahtukit	वाहतूकीत	वाहतुकीत

vikanyaachi	विका्याची	विकण्याची

viknyachee	विका्याची	विकण्याची

viknyachi	विका्याची	विकण्याची

vikanyachya	विका्याच्या	विकण्याच्या

viknyachya	विका्याच्या	विकण्याच्या

vikata	विकता	विकता

vikta	विकता	विकता

vikala	विकला	विकला

vikla	विकला	विकला

vikale	विकले	विकले

vikle	विकले	विकले

vikalp	विकल्प	विकल्प

vichaarto	विचारतो	विचारतो

vicharato	विचारतो	विचारतो

vicharto	विचारतो	विचारतो

vichaardharechey	विचारधारेचे	विचारधारेचे

vichardhareche	विचारधारेचे	विचारधारेचे

vijayavada	विजयाादा	विजयवाडा

vijayawada	विजयाादा	विजयवाडा

vijayvada	विजयाादा	विजयवाडा

vijaywada	विजयााद	विजयवाडा

vizayavada	विजयााद	विजयवाडा

vizayvada	विजयााद	विजयवाडा

vizaywada	विजयााद	विजयवाडा

wijayawada	विजयाादा	विजयवाडा

wijaywada	विजयाादा	विजयवाडा

vidnyanat	विद्ञानात	विज्ञानात

vigyanaat	विग्ञानात	विज्ञानात

vijhoon	विझून	विझून

vijhun	विजून	विझून

vizun	विजून	विझून

vitancha	वितांचा	विटांचा

vitanchya	वितांच्या	विटांच्या

vithabai	विठाबाई	विठाबाई

vidarbh	विदर्भ	विदर्भ

viddarbh	विद््भ	विदर्भ

veedya	वेद्या	विद्या

vidya	विद्या	विद्या

viidya	विद्या	विद्या

weedya	वेद्या	विद्या

widya	विद्या	विद्या

vidyancha	विद्यांचा	विद्यांचा

vidyarthineela	विद्यारीथीनाला	विद्यार्थिनीला

vidyarthinila	विद्यार्थीनाला	विद्यार्थिनीला

vidyala	विद्याला	विद्याला

vidheyak	विधेयक	विधेयक

vidheyakala	विध्यकाला	विधेयकाला

vinamratene	विनाररताने	विनम्रतेने

vinaadathala	विनादडााा	विनाअडथळा

vinaadthala	विनादधााा	विनाअडथळा

vineeta	विनिता	विनीता

vinita	विनिता	विनीता

veefal	विफल	विफल

vifal	विफा	विफल

viphal	विफल	विफल

veebhagla	विभागला	विभागला

vibhagala	विभागला	विभागला

veebhagli	विभागली	विभागली

vibhagalee	विभागली	विभागली

vibhagali	विभागली	विभागली

vibhagalya	विभागल्या	विभागल्या

vibhagahee	विभागाी	विभागही

vibhagahi	विभागाी	विभागही

vibhagancha	विभागांचा	विभागांचा

vibhaganchya	विभागांच्या	विभागांच्या

vibhaganna	विभागांना	विभागांना

vibhagakade	विभागाकडे	विभागाकडे

vibhagacha	विभागाचा	विभागाचा

vibhagachee	विभागाची	विभागाची

vibhagachi	विभागाची	विभागाची

vibhagache	विभागाचे	विभागाचे

vibhagane	विभागाने	विभागाने

vibhagashee	विभागाशी	विभागाशी

vibhagashi	विभागाशी	विभागाशी

vibhagasathi	विभागासाठी	विभागासाठी

vibhagiy	विभागीय	विभागीय

vibhagiya	विभागीय	विभागीय

veeranguda	विरंगाळा	विरंगुळा

virangula	विरंगुला	विरंगुळा

veerodhkanchya	विरोधकांच्या	विरोधकांच्या

virodhakanchya	विरोधाांच्या	विरोधकांच्या

virodhkanchya	विरोधकांच्या	विरोधकांच्या

vilay	विलय	विलय

vealis	वेलेस	विलिस

vilis	विल्स	विलिस

wealis	वेल्स	विलिस

welis	वेल्स	विलिस

wilis	विल्स	विलिस

vishayak	विषयक	विषयक

vishayavar	विषयावर	विषयावर

vishayavarachee	विशयावराी	विषयावरची

vishayavarachi	विषयावराी	विषयावरची

vishayavarchi	विषयावराी	विषयावरची

vishayeechee	विषयाची	विषयीची

vishayichi	विषयाची	विषयीची

vishanoonchee	विषणंूंची	विषाणूंची

vishanunchee	विशणंूंची	विषाणूंची

vishanunchi	विषणणूंची	विषाणूंची

vishanoonchya	विशणणूंच्या	विषाणूंच्या

vishanunchya	विषाणूंच्या	विषाणूंच्या

vishanoocha	विषणणूचा	विषाणूचा

vishanucha	विषाणूचा	विषाणूचा

vishanoochya	विषणणूच्या	विषाणूच्या

vishanuchya	विषणणूच्या	विषाणूच्या

vishanoomule	विष्णुमुळे	विषाणूमुळे

vishanumule	विषांुमुळे	विषाणूमुळे

vihangam	विहागाा	विहंगम

veehar	विहार	विहार

vihar	विहार	विहार

vihara	विहारा	विहार

viihar	विहार	विहार

weehar	विहार	विहार

wihar	विहार	विहार

wihara	विहारा	विहार

viharee	विहारी	विहारी

vihari	विहररी	विहारी

veej	वीज	वीज

vij	वीज	वीज

weej	वीज	वीज

veeta	विता	वीटा

vita	विता	वीटा

veesek	वेसिक	वीसेक

visek	विसिक	वीसेक

vrushan	वृष्	वृषण

vengurla	वेंगूळलला	वेंगुर्ला

vegalee	वेगळी	वेगळी

vegaleech	वेगळीच	वेगळीच

vede	वेडे	वेडे

venoo	विणू	वेणू

vedana	वेदाा	वेदना

vedna	वेदना	वेदना

vedanamay	वेदनामय	वेदनामय

vednamay	वेदाामी	वेदनामय

vellor	वेलरयरर	वेल्लोर

vellore	वेल्यूरी	वेल्लोर

vaitarana	वैतरणा	वैतरणा

vaitarna	वैतरणा	वैतरणा

vainshapayan	वैनंपायन	वैशंपायन

vaishanpayan	वैशापणयण	वैशंपायन

vaishpayan	वैशपपाय	वैशंपायन

vyangya	व्याग्या	व्यंग्य

vyavasthapan	व्यवसाथापन	व्यवस्थापन

vyvasthapan	व्यवस्थापन	व्यवस्थापन

vyavasthapanachi	व्यवस्थानााची	व्यवस्थापनाची

vyvasthapanachi	व्यवस्थापााची	व्यवस्थापनाची

vyavastapanachya	व्यवस्तापनाच्या	व्यवस्थापनाच्या

vyavasthapanachya	व्यवस्थाननाच्या	व्यवस्थापनाच्या

vyvasthapanachya	व्यवस्थापनाच्या	व्यवस्थापनाच्या

vyavasthapanatil	व्यवस्थापाातील	व्यवस्थापनातील

vyvasthapanatil	व्यवस्थापाातील	व्यवस्थापनातील

vyavasthapanane	व्यवस्थापनाने	व्यवस्थापनाने

vyvasthapanane	व्यवस्थाननाने	व्यवस्थापनाने

vyavasthapanamadhye	व्यवस्थापनामध्ये	व्यवस्थापनामध्ये

vyavsthapanamadhye	व्यवस्थाननामध्ये	व्यवस्थापनामध्ये

vyvasthapanamadhe	व्यवे्थापाामधीये	व्यवस्थापनामध्ये

vyavasthapanavar	व्यवस्थानाावर	व्यवस्थापनावर

vyavsthapanavar	व्यवस्थानाावर	व्यवस्थापनावर

vyvasthapanavar	व्यवस्थानाारर	व्यवस्थापनावर

vyavasthapanasathi	व्यवस्थापनासाठी	व्यवस्थापनासाठी

vyavsthapanasathee	व्यवस्थापाासांी	व्यवस्थापनासाठी

vyvasthapanasaathi	व्यवस्थापाासाठी	व्यवस्थापनासाठी

vyavasthit	व्यवस्थित	व्यवस्थीत

vyavstheet	व्यवस्थित	व्यवस्थीत

vyvasthit	व्यसस्थित	व्यवस्थीत

vyavasthechya	व्यवस्थेच्या	व्यवस्थेच्या

vyavsthechya	व्यवस्थेच्या	व्यवस्थेच्या

vyavasthetil	व्यवस्थेतील	व्यवस्थेतील

vyavstheteel	व्यवस्थेतील	व्यवस्थेतील

vyavasthemule	व्यवसेथेमुळे	व्यवस्थेमुळे

vyavsthemule	व्यवस्थेमुळे	व्यवस्थेमुळे

vyavasthela	व्यवस्थेला	व्यवस्थेला

vyavsthela	व्यवस्थेला	व्यवस्थेला

vyavasthevar	व्यवसेथेवर	व्यवस्थेवर

vyavsthevar	व्यवस्थेवर	व्यवस्थेवर

vyasanmuktee	व्यसंमुत्ती	व्यसनमुक्ती

vyakhya	व्याख्या	व्याख्या

vyakhyan	व्याख्यान	व्याख्यान

vyakhyana	व्याख्याना	व्याख्यानं

vyakhyanam	व्याखययांा	व्याख्यानं

vyakhyann	व्याख्यांं	व्याख्यानं

vyakhyanacha	व्याख्यानाचा	व्याख्यानाचा

vyakhyanachya	व्याख्यांाच्या	व्याख्यानाच्या

vyakhyanasathee	व्याखययानासाठी	व्याख्यानासाठी

vyakhyanasathi	व्याख्यानासाठी	व्याख्यानासाठी

vyapate	व्यापते	व्यापते

vyayamprakar	व्यायपपप्रकार	व्यायामप्रकार

vheitnam	व्हिएतनाम	व्हिएटनाम

vhiyatnam	व्हिएतनाम	व्हिएटनाम

vietman	विहिएमन	व्हिएटनाम

vheelar	व्हीलर	व्हीलर

wheelar	व्हीलर	व्हीलर

wheeler	व्हीलर	व्हीलर

shakanarya	शकणाऱ्या	शकणाऱ्या

shaknarya	शकणाऱ्या	शकणाऱ्या

shakalyane	शकल्याने	शकल्याने

shaklyane	शकल्याने	शकल्याने

shakalyas	शकल्यास	शकल्यास

shaklyas	शकल्यास	शकल्यास

shakel	शकेल	शकेल

shakya	शक्यााा	शक्य

shakyahi	शा्याी	शक्यही

shatapavali	शताावली	शतपावली

shatpavali	शतपावली	शतपावली

shatpavli	षतपावली	शतपावली

shabari	शााी	शबरी

shabri	शब्ी	शबरी

shamichya	शाीच्या	शमीच्या

sart	सा्ट	शर्ट

shart	शॉ्ट	शर्ट

shhart	शॉ्ट	शर्ट

shhirt	शि्ट	शर्ट

shhurt	स््ट	शर्ट

shirt	शि्ट	शर्ट

shurt	सू्ट	शर्ट

sirt	सि्ट	शर्ट

surt	सू्ट	शर्ट

shastrakriyechya	शस्त्रकिरियाच्या	शस्त्रक्रियेच्या

shastrakriyet	शस्त्रक्रिततत	शस्त्रक्रियेत

shastrakriyenantar	शस्त्रा्रियांंतर	शस्त्रक्रियेनंतर

shaharatach	शहरातच	शहरातच

shaharaathi	शहराथही	शहरातही

shaharatahee	शहरातही	शहरातही

shaharatahi	शहरातही	शहरातही

sanghai	संंघाई	शांघाय

sanghaiye	सांघायीे	शांघाय

sanghay	संंघयय	शांघाय

sanghaya	संंघायाा	शांघाय

shaanghaya	शांघययाा	शांघाय

shanghai	शंंघाई	शांघाय

shanghaiye	शांगायेे	शांघाय

shanghay	शंंघयय	शांघाय

shanghaya	शंंघायाा	शांघाय

shanghe	शंंघे	शांघाय

shangheye	शांघेयेे	शांघाय

shanjhai	शंंजाय	शांघाय

shanjhaiye	शंंजायेेय	शांघाय

shanjhay	शंंजयय	शांघाय

shanjhaya	शंंजाय	शांघाय

shhanghai	शंंघाय	शांघाय

shhanghaiye	शंंगायेे	शांघाय

shhanghay	शंंघयय	शांघाय

shhanghaya	शंंघययाा	शांघाय

shaakir	शाक्र	शाकीर

shakeer	शाकीर	शाकीर

shaaduchya	शादूच्या	शाडूच्या

shadoochya	शादूच्या	शाडूच्या

shaaraja	शाराा	शारजा

sharaja	शररजा	शारजा

sharja	शरर्ा	शारजा

shasak	शासक	शासक

shasakannee	शासकांनी	शासकांनी

shasakanni	शासकांनी	शासकांनी

shahoonagar	शहहोनगर	शाहूनगर

shahunagar	शहहुनगर	शाहूनगर

shinde	शिंदे	शिंदे

shindenchya	शिंडेंच्या	शिंदेंच्या

shindene	शिंदेने	शिंदेने

sheeuar	शेअर	शिऊर

shioor	शिओर	शिऊर

shiuur	शूअर	शिऊर

shikkamortab	शिक्कारोरतत	शिक्कामोर्तब

shikshan	शिक्षण	शिक्षण

shikshanach	शिक्षणा	शिक्षणच

shikshanapaddhatee	शिक्षणपद्धती	शिक्षणपद्धती

shikshanpaddhati	शिक्षणपद्धीी	शिक्षणपद्धती

shikshanpadhati	शिक्षणपदाथीी	शिक्षणपद्धती

shikshanvishayak	शिक्षणििष्क	शिक्षणविषयक

shikshanavyavasthet	शिक्षणा्यास्थेत	शिक्षणव्यवस्थेत

shikshanvyavasthet	शिक्षण्ायास्थात	शिक्षणव्यवस्थेत

sheekshanaacha	शिक्षणाचा	शिक्षणाचा

shikshanacha	शिक्षणाचा	शिक्षणाचा

sheekshanaachi	शिक्षणाही	शिक्षणाची

shikshanachi	शिक्षणाची	शिक्षणाची

sheekshanaache	शिक्षणाचे	शिक्षणाचे

shikshanache	शिक्षणाचे	शिक्षणाचे

sheekshanaat	शिक्षणात	शिक्षणात

shikshanat	शिक्षणात	शिक्षणात

sheekshanaatil	शिक्षणातील	शिक्षणातील

shikshanatil	शिक्षणातील	शिक्षणातील

sheekshanaane	शिक्षणाने	शिक्षणाने

shikshanane	शिक्षणाने	शिक्षणाने

sheekshanaabarobarach	शिक्षणाबरोबाह	शिक्षणाबरोबरच

shikshanabarobarach	शिक्षणबबरोबचह	शिक्षणाबरोबरच

sheekshanaamude	शिक्षणामुळे	शिक्षणामुळे

shikshanamule	शिक्षणामुळे	शिक्षणामुळे

sheekshecha	शेक्षेचा	शिक्षेचा

shikshecha	शिक्षेचा	शिक्षेचा

sheekshela	शिक्षेला	शिक्षेला

shikshela	शिक्षेला	शिक्षेला

shigela	शिगेला	शिगेला

shijavila	शिजाीला	शिजविला

shiradhon	शिरधून	शिरढोण

shirdhon	शिर्ून	शिरढोण

shiromane	शिरोमाा	शिरोमणी

shiromanee	शिरोमणी	शिरोमणी

shiromani	शिरोणाी	शिरोमणी

shirolee	शिरोळी	शिरोली

shiroli	शिरोळी	शिरोली

shhilanga	शिलगंग	शिलाँग

shhillong	शिल्ंग	शिलाँग

shilanga	शिलंंग	शिलाँग

shillang	शिल्ंग	शिलाँग

shillong	शिलोवग्	शिलाँग

shilong	शिलोंग	शिलाँग

silanga	सिलंंग	शिलाँग

sillong	सिल्ंग्	शिलाँग

shilpakala	शिल्पकाा	शिल्पकला

shilpkala	शिल्पकाा	शिल्पकला

shivarampant	शिवरंंपंत	शिवरामपंत

shivrampant	शिवर्ंपंत	शिवरामपंत

shivaray	शिवााय	शिवराय

shivray	शिवराय	शिवराय

shivarayancha	शिवरायंंचा	शिवरायांचा

shivrayancha	शिवरायांचा	शिवरायांचा

shivarayanchi	शिवाायांची	शिवरायांची

shivrayanchi	शिवरायणंची	शिवरायांची

shivarayanchya	शिवाणयनंच्या	शिवरायांच्या

shivrayanchya	शिवर्यचंच्या	शिवरायांच्या

shishn	शिष्न	शिश्न

shishr	शिष्र	शिश्न

sheet	शीत	शीट

shit	सीत	शीट

shukla	शुकलला	शुक्ला

shuddh	शुद्ध	शुद्घ

shuddha	शुद्धाा	शुद्घ

shudgha	शुद्घ	शुद्घ

shares	शेरर	शेअर्स

shears	शेरर्स	शेअर्स

shadenet	शादनेत	शेडनेट

shednet	शेदणेत	शेडनेट

shetamalachee	शेतकालाची	शेतमालाची

shetamalachi	शेतकालयची	शेतमालाची

shetmalachi	शेतकाळाची	शेतमालाची

shetamalache	शेतकाळाचे	शेतमालाचे

shetmalache	शेतकालचचे	शेतमालाचे

shetatach	शेतातच	शेतातच

seffield	सेफिल्ड	शेफील्ड

sephild	सीफलल	शेफील्ड

sheeffieeld	शफफफल्ड	शेफील्ड

sheephild	शीफील	शेफील्ड

sheffield	शेफललिड	शेफील्ड

sheffiield	शेफलल्ड	शेफील्ड

shefild	शेफलल	शेफील्ड

shephiild	शीफलल	शेफील्ड

shephild	शीफलल	शेफील्ड

shephphield	शेफिल्फ	शेफील्ड

shheffield	शेफिल्ड	शेफील्ड

shhephild	शीफलल	शेफील्ड

saron	सररून	शेरॉन

seran	सेरान	शेरॉन

sharan	शररणन	शेरॉन

sharon	शररून	शेरॉन

sheeran	शेरणन	शेरॉन

sheran	शेरणन	शेरॉन

sheron	शेरोन	शेरॉन

shharon	शररून	शेरॉन

shheran	शेरणन	शेरॉन

sail	सैल	शेल

sel	सील	शेल

sell	सेल	शेल

shail	शैल	शेल

sheel	शील	शेल

sheell	शील	शेल

shel	शील	शेल

shell	शेल	शेल

shhail	शेल	शेल

shhel	शेल	शेल

shhell	शेल	शेल

shok	शॉक	शोक

shobhane	शोभणे	शोभणे

shobhne	शोभणे	शोभणे

shobhoon	शूभून	शोभून

shobhun	शोभून	शोभून

shrikrishanachya	श्रीक्षणयाच्या	श्रीकृष्णाच्या

shrikrishnachya	श्रीकरष्णां्या	श्रीकृष्णाच्या

shrikrushnachya	श्रीकृष्णाच्या	श्रीकृष्णाच्या

shrikrishanane	श्रीक्षणणाने	श्रीकृष्णाने

shrikrishnane	श्रीक्षाणाने	श्रीकृष्णाने

shrikrushnane	श्रीकृषाणाने	श्रीकृष्णाने

shrirang	श्रीरंग	श्रीरंग

shhrooti	श्रोती	श्रुती

shhruti	श्रृती	श्रुती

shraati	श्रतती	श्रुती

shrooti	श्रूती	श्रुती

shrootii	श्रूती	श्रुती

shruti	श्रृती	श्रुती

shrutii	श्रृती	श्रुती

srooti	स्रूती	श्रुती

sruti	स्रृती	श्रुती

sandavich	संदाेच	सँडविच

sandawich	संडाेच	सँडविच

sandvich	संड्िच	सँडविच

sandvitch	संदवितत	सँडविच

sandwich	सॅड्ेच	सँडविच

sandwitch	संदवेच	सँडविच

sankatancha	संकाांचा	संकटांचा

sankatanna	संकानंना	संकटांना

sankatachya	संकतकच्या	संकटाच्या

sankatamule	संकाामुळे	संकटामुळे

sankate	संकते	संकटे

sangrahan	साग्रहा	संग्रहण

sangrahalay	संग्रहालय	संग्रहालय

sangrahalayachee	संग्रहालयाची	संग्रहालयाची

sangrahalayachi	संग्रहालयाची	संग्रहालयाची

sangrahalayachya	संग्रहालयाच्या	संग्रहालयाच्या

sanghatak	संघाक	संघटक

sanchari	संचारी	संचारी

sampate	संपते	संपते

samnpavale	संमााा	संपवले

sampavale	संपाले	संपवले

sampavoon	संपाून	संपवून

sampadak	संपादक	संपादक

sampadakannee	संप्दकांनी	संपादकांनी

sampadakanni	संपादकांनी	संपादकांनी

sampadakache	संपादकाचे	संपादकाचे

sambandh	संबंध	संबंध

sambhandh	संबंध	संबंध

sambandhancha	संबंधांचा	संबंधांचा

sambhandhancha	संबंधांचा	संबंधांचा

sambandhanchee	संबंधांची	संबंधांची

sambandhanchi	संबंधांची	संबंधांची

sambhandhanchee	संबंधांची	संबंधांची

sambadhanna	संबंधननना	संबंधांना

sambandhanna	संबंधांना	संबंधांना

sambhandhanna	संबंधांना	संबंधांना

sambadhanvar	संबंधाववर	संबंधांवर

sambandhanvar	संबंधांवर	संबंधांवर

sambadhachya	संबंधाच्या	संबंधाच्या

sambandhachya	संबंधाच्या	संबंधाच्या

sambadhatoon	संबंधततून	संबंधातून

sambandhatoon	संबंधातून	संबंधातून

sambhandhatoon	संबंधततून	संबंधातून

sambhal	संभाळ	संभाल

sanyogane	संयोगनने	संयोगाने

sanyojak	संयोजक	संयोजक

sanvatsar	संवत्सा	संवत्सर

sanvatsaracha	संवा्रराचा	संवत्सराचा

sanvedan	संवेदन	संवेदन

sanvedana	संवेदन	संवेदना

sanvedananche	संवेदनांचे	संवेदनांचे

sanshodhak	संशोधक	संशोधक

sanshodhakancha	संशोधाानचा	संशोधकांचा

sanshodhakanche	संशोधाांचे	संशोधकांचे

sanshodhakanchya	संशोधाांच्या	संशोधकांच्या

sanshodhakanna	संशोधनांना	संशोधकांना

sanshodhakannee	संशोधाांनी	संशोधकांनी

sanshodhakanni	संशोधाांनी	संशोधकांनी

sanshodhakansathee	संशोधाांसाठी	संशोधकांसाठी

sanshodhakansathi	संशोधाांसाठी	संशोधकांसाठी

sansaar	सनसार	संसार

sansar	संसरर	संसार

sanskaran	संस्काण	संस्करण

sanskaar	संस्कार	संस्कार

sanskar	संस्कार	संस्कार

sanskaaracha	संस्काराचा	संस्काराचा

sanskaracha	संस्काराचा	संस्काराचा

sanskareet	संस्कररित	संस्कारित

sanskarit	संस्कररित	संस्कारित

sansthekadoon	संस्थेकडून	संस्थेकडून

sansthekadun	संस्थेकडून	संस्थेकडून

sansthechee	संस्थेची	संस्थेची

sansthechi	संस्थेची	संस्थेची

sansthechya	संस्थेच्या	संस्थेच्या

sansthetoon	संस्थेनून	संस्थेतून

sansthetun	ससस्थेनून	संस्थेतून

sansthene	संस्थेने	संस्थेने

sansthemadhye	संस्थेमध्ये	संस्थेमध्ये

sansthela	संस्थेला	संस्थेला

sanstheshi	संस्थेशी	संस्थेशी

sansthesaathi	संस्थेशाठी	संस्थेसाठी

sansthesathi	संस्थेसाठी	संस्थेसाठी

sakreeya	सक्रेय	सक्रीय

sakriy	सक्रिय	सक्रीय

sakriya	सक्रिय	सक्रीय

sakhal	सखा	सखल

sanavar	साारर	सणवार

sanvar	सं्ार	सणवार

satarave	सााावे	सतरावे

satrave	सतरावे	सतरावे

satkarm	सत्का्म	सत्कर्म

satkar	सत्करर	सत्कार

sattechi	सत्तेची	सत्तेची

sattet	सत्तेत	सत्तेत

satyajeet	सत्यजीत	सत्यजीत

satyajit	सत्यजित	सत्यजीत

satyamev	सत्यमेव	सत्यमेव

sanad	साद	सनद

sanachya	सनाच्या	सनाच्या

sanee	साी	सनी

sani	सॅी	सनी

sanii	सनी	सनी

sunee	सुी	सनी

suni	सुी	सनी

sunii	सुी	सनी

sunni	सु्	सनी

sunnii	सु्	सनी

sunny	सु्	सनी

suny	सुी	सनी

sapshel	साशेल	सपशेल

special	स््ाल	सपशेल

sapteembar	सं्तीमबर	सप्टेंबर

sapteembara	सं्तीमबर	सप्टेंबर

saptembar	सा्तेमबर	सप्टेंबर

saptembara	सं्तेमबर	सप्टेंबर

seepteembeer	से्पीममर	सप्टेंबर

septembar	सेेटेमबर	सप्टेंबर

september	से्टेमबर	सप्टेंबर

shaptembar	शा्तममबर	सप्टेंबर

shaptembara	सा्तेमबर	सप्टेंबर

sheptember	सेेटेममर	सप्टेंबर

sabhasadakadun	सभासााककडून	सभासदांकडून

sabhasadakdonn	सभासदाककडून	सभासदांकडून

sabhasadankadoon	सभासंानकडून	सभासदांकडून

sabhasadankadun	सभासाांकडून	सभासदांकडून

sabhasadancha	सभासदांचा	सभासदांचा

sabhasadanche	सभासाांचे	सभासदांचे

sabhasadanna	सभासाांना	सभासदांना

sabhasadannee	सभासाांनी	सभासदांनी

sabhasadanni	सभासाांनी	सभासदांनी

samabhuj	समाूज	समभुज

sambhuj	संंूज	समभुज

samayi	सााी	समयी

samlaingik	समलेनगिक	समलैंगिक

samlangik	संलंंगिक	समलैंगिक

samasyecha	समस्येचा	समस्येचा

samasyevar	सास्येवर	समस्येवर

samajasudharak	समाजाुधकरक	समाजसुधारक

samajsudharak	समाजसुधाकक	समाजसुधारक

samikaran	समीकाण	समिकरण

samiti	समिती	समिति

samuhache	समूहाचे	समुहाचे

samuhateel	समूहातील	समुहातील

samuhatil	समूहातील	समुहातील

sarada	सराा	सरडा

sarda	सर्ा	सरडा

sardaranche	सरदारांचे	सरदारांचे

sardaranni	सााारांनी	सरदारांनी

sardarane	सरदाराने	सरदाराने

sardarala	सर्ाराला	सरदाराला

sardesai	सरदेशीई	सरदेसाई

sarpanch	सरपाच	सरपंच

sarpancha	सरपाचााा	सरपंच

saral	सरळ	सरल

saralata	सरळता	सरलता

sarlata	सर्ता	सरलता

sarasavalee	सरसलवली	सरसावली

sarsavali	सरसलवली	सरसावली

sarahadda	सरहद्द	सरहद्द

sarhadd	सरहद्द	सरहद्द

sarita	सरीता	सरिता

saroop	सरूप	सरूप

sarup	सरुप	सरूप

sardee	सरदडे	सर्दी

sardi	शर्डी	सर्दी

sarvang	सर्वांग	सर्वांग

sarvangaane	सर्वाजगणने	सर्वांगाने

sarvangane	सर्वांगणने	सर्वांगाने

sarvangavar	सरववानगावर	सर्वांगावर

salagpane	सला्णे	सलगपणे

salameeveer	सलममीवरर	सलामीवीर

salamiveer	सलममीवरर	सलामीवीर

sashart	सशर्त	सशर्त

sasharta	सार्त	सशर्त

sase	सेे	ससे

sahakarya	सहकाऱ्‍	सहकार्य

sahkarya	सहकाऱ्य	सहकार्य

sahkaryaache	सहकाऱ्याचा	सहकार्याचे

sahkaryache	सहकाऱ्याचे	सहकार्याचे

sahkaryatoon	सहकार्यातून	सहकार्यातून

sahkaryatun	सहकाऱ्यातून	सहकार्यातून

sahkaryane	सहकाऱ्याने	सहकार्याने

saharachya	सहाराच्या	सहाराच्या

sakuree	साकुरी	साकुरी

sakuri	सककुरी	साकुरी

sakeet	सककीत	साकेत

sakeeta	सककीताा	साकेत

saket	सकक्त	साकेत

saketa	सककेताा	साकेत

saqet	सकक्त	साकेत

saqeta	सकक्ता	साकेत

saj	साज	साज

sajeshee	साजेशी	साजेशी

sajeshi	सजजेशी	साजेशी

sathye	साथ्ये	साठ्ये

sadya	सदड्या	साड्या

sadyanchee	सदद्यांची	साड्यांची

sadyanchi	साय्यांची	साड्यांची

satpuda	सततपुळा	सातपुडा

sataryaat	सततरऱ्यात	साताऱ्यात

sataryat	सतत्ऱ्यात	साताऱ्यात

sato	सततो	सातो

satoo	सततू	सातो

seto	सायो	सातो

sadhanechee	साधनेची	साधनेची

sadhanechi	साधनेची	साधनेची

sadhnechee	साध्ेची	साधनेची

sadhanet	साधनेत	साधनेत

sadhnet	साधनेत	साधनेत

sadhaneteel	साधनातील	साधनेतील

sadhanetil	साधनेतील	साधनेतील

sadhneteel	साधनेतील	साधनेतील

sadhanene	साधनेने	साधनेने

saniya	सननिया	सानिया

sam	साम	साम

samajik	सममाजिक	सामाजिक

saynsache	सेयनासाे	सायन्सचे

scienceche	सियनेसेे	सायन्सचे

sayansmadhye	सायनासमध्ये	सायन्समध्ये

sciencemadhye	सियक्सेध्ये	सायन्समध्ये

cybar	सायबर	सायबर

cyber	सायबर	सायबर

sayabara	सायबर	सायबर

saybar	सायबर	सायबर

shayabara	शायार	सायबर

shyber	शायबर	सायबर

sybar	सियबर	सायबर

syber	सियबर	सायबर

sarakh	सारख	सारख

sarkh	सारख	सारख

saaran	सररण	सारण

saran	सररण	सारण

sarana	सररणा	सारण

shaaran	शररन	सारण

sharana	शररणा	सारण

sarani	सररणी	सारणी

sarni	सरर्ी	सारणी

sarbhut	सारभूत	सारभूत

saalunki	सालुंकी	साळुंकी

salunki	सालुंकी	साळुंकी

savanga	सववंग	सावंगा

savar	सववर	सावर

savara	सववरााा	सावर

sawar	सावर	सावर

sawara	सावरााा	सावर

savarla	सावर्ा	सावरला

savrala	सावराा	सावरला

savali	सववली	सावली

savli	सावली	सावली

savalicha	सववलीचा	सावलीचा

savlicha	सववलीचा	सावलीचा

sasarche	सासरचे	सासरचे

sasaree	सासरी	सासरी

sasari	सससरी	सासरी

sasri	सशशरी	सासरी

sasare	सससरे	सासरे

sasre	सेसरे	सासरे

sasooche	सससूचे	सासूचे

sasuche	सससूचे	सासूचे

sahaskatha	सहहस्था	साहसकथा

sahebanchya	सहहेबांच्या	साहेबांच्या

sahebanna	सहहेबांना	साहेबांना

sahebee	साहेबी	साहेबी

sahebi	साहेबी	साहेबी

sing	सिंग	सिंग

singer	सिंगर	सिंगर

sigmand	सिए्माद	सिग्मंड

sigmond	सिए्माड	सिग्मंड

citizen	सिटिज	सिटीझन

siteejhan	सिटीफन	सिटीझन

siddee	सिड्दी	सिद्दी

siddi	सिद्दी	सिद्दी

siddhantacha	सिद्धांतचचा	सिद्धांताचा

siddhantachee	सिद्धांताची	सिद्धांताची

siddhantachi	सिद्धांताची	सिद्धांताची

siddhantat	सिद्धांतात	सिद्धांतात

siddhantavar	सिद्धांतरवर	सिद्धांतावर

siddhantawar	सिद्धांतररर	सिद्धांतावर

siva	सिवा	सिवा

seemit	सीमित	सीमित

simit	सिमित	सीमित

sundar	सुंदर	सुंदर

sundarta	सुंदर्ा	सुंदरता

sukhavale	सुखववले	सुखावले

sukhavle	सुखववले	सुखावले

sujan	सुजा	सुजन

suzan	सुजा	सुजन

sujit	सुजीत	सुजित

suttee	सुटतती	सुट्टी

sutti	सुटतटी	सुट्टी

sutteeche	सुटीटेचे	सुट्टीचे

suttiche	सुटटटीचे	सुट्टीचे

sutteechya	सुटीटीच्या	सुट्टीच्या

suttichya	सुटीटीच्या	सुट्टीच्या

sutteemadhye	सूटीयेमध्ये	सुट्टीमध्ये

suttimadhe	सूटीयेमध्ये	सुट्टीमध्ये

suttimadhye	सूटीयीमध्ये	सुट्टीमध्ये

sutache	सुटाचे	सुताचे

saadan	सददान	सुदान

soodan	सोडान	सुदान

sudaan	सुडान	सुदान

sudan	सुडान	सुदान

sudana	सुदाना	सुदान

soodur	सुद्र	सुदूर

sudoor	सुदूर	सुदूर

sudur	सुदूर	सुदूर

sudradh	सुद्ध	सुदृढ

sudrudh	सुदृढ	सुदृढ

sudrudha	सुद्ढ	सुदृढ

sunavala	सुनावाा	सुनावला

sunavali	सुनावली	सुनावली

sunavale	सुनावले	सुनावले

supt	सूप्त	सुप्त

supta	सुप्त	सुप्त

sur	सरर	सुर

soorat	सूरा	सुरत

surat	सुरा	सुरत

surata	सुराााा	सुरत

sureta	सुरेााा	सुरत

suratla	सुरूला	सुरतला

suravatichya	सुराणतीच्या	सुरवातीच्या

survatichya	सूरवटटीच्या	सुरवातीच्या

survatipasun	सूरवातीपासून	सुरवातीपासून

suranchi	सुरांची	सुरांची

suranchya	सुरांच्या	सुरांच्या

surya	सूर्या	सुर्या

suryachya	सूर्याच्या	सुर्याच्या

shooltan	शूलतान	सुलतान

shulatan	शुलतान	सुलतान

sooltan	सोलतान	सुलतान

sulatan	सुलतान	सुलतान

sultan	सुलतान	सुलतान

sultanannee	सुल्ानांनी	सुलतानांनी

sultananni	सुल्ानांनी	सुलतानांनी

sultanane	सुलतानाने	सुलतानाने

sultan	सुलततनन	सुल्तान

suvarnakamal	सुवर्नकाळ	सुवर्णकमळ

suvarnkamal	सुवर्मकाळ	सुवर्णकमळ

suvarnamai	सुवरणणाा	सुवर्णमय

suvarnamay	सुवर्णमय	सुवर्णमय

suvarnmay	सुवर्मम्	सुवर्णमय

suvarnayog	सुवर्णयगग	सुवर्णयुग

suvarnayug	सुरर्णयगग	सुवर्णयुग

suvarnyug	सुवर्यगुग	सुवर्णयुग

suwarnayug	सुवरणणयगग	सुवर्णयुग

susanghatit	सुशंघतित	सुसंघटित

susanghtit	सुसंघतित	सुसंघटित

susanskarit	सुसंस्कारित	सुसंस्कारित

susajj	सुसजाग	सुसज्ज

susajja	सुसजाजा	सुसज्ज

susvabhavee	सुस्वाववी	सुस्वभावी

susvabhavi	सुस्वाावी	सुस्वभावी

suryodayachi	सूर्यादयाची	सूर्योदयाची

suryodayapasoon	सुर्ययदयपपासून	सूर्योदयापासून

suryodayapasun	सरर्योदयपपासून	सूर्योदयापासून

sain	सेन	सॅन

san	सान	सॅन

sana	सनन	सॅन

sen	सेन	सॅन

shain	शेन	सॅन

shan	शान	सॅन

shana	सनन	सॅन

second	सेकंड	सेकंद

secondala	सेकोडोला	सेकंदाला

cellche	सेलचे	सेलचे

saleche	सललेे	सेलचे

sellche	सेल्ा	सेलचे

sevika	सेविका	सेविका

sainyasah	सैन्यासह	सैन्यासह

senyasaha	सैन्यासह	सैन्यासह

songatee	सोंगटी	सोंगटी

songati	सोंगती	सोंगटी

sonar	सोनरर	सोनार

sonara	सोनरराा	सोनार

soonar	सोनरर	सोनार

soonara	सोनरराा	सोनार

soap	सोप	सोप

sooap	सूप	सोप

soop	सूप	सोप

sop	सोप	सोप

sopaskar	सोपशाकरर	सोपस्कार

sopi	सोपी	सोपी

sobateene	सोबाीने	सोबतीने

sobteene	सोबतीने	सोबतीने

sobtine	सोबतीने	सोबतीने

somnath	सोमनाथ	सोमनाथ

soviat	सोविहिएात	सोव्हियेत

soviet	सोविहिएेट	सोव्हियेत

social	सोसि	सोशल

saujanya	सौजन्या	सौजन्य

soajanya	सोजा्याा	सौजन्य

saujanyane	सौजन्याने	सौजन्याने

scaaba	स्कॉबा	स्कुबा

scooba	स्कोबा	स्कुबा

scuba	स्कोबा	स्कुबा

skuba	स्कुबा	स्कुबा

squba	स्कोबा	स्कुबा

stadiumchi	स्टाडमममीी	स्टेडियमची

stediyamchee	स्टेडिमाीी	स्टेडियमची

stationary	स्टेशनी्	स्टेशनरी

stationery	स्टेटनिी	स्टेशनरी

steshanaree	स्टेशनाी	स्टेशनरी

stutya	स्टुत्यााा	स्तुत्य

sthanikankadoon	स्थानिकांकडून	स्थानिकांकडून

sthanikankadun	स्थानिकांकडून	स्थानिकांकडून

sthaneekanna	स्थानिकांना	स्थानिकांना

sthanikanna	स्थानिकांना	स्थानिकांना

sthayibhaav	स्थियभभाव	स्थायीभाव

sthayibhav	स्थियीभाव	स्थायीभाव

stheet	स्थित	स्थित

sthit	स्थित	स्थित

spead	स्पीड	स्पीड

sped	स्पेड	स्पीड

speed	स्पीड	स्पीड

spid	स्पीड	स्पीड

spiid	स्पीड	स्पीड

spaem	स्पेम	स्पॅम

spam	स्पमम	स्पॅम

sfatik	स्फािक	स्फटिक

sphatik	स्फािक	स्फटिक

swatachich	स्वतःचिच	स्वतःचीच

swatahchich	स्वतःचिच	स्वतःचीच

svarupat	स्वरुपात	स्वरूपात

swarupat	स्वरूपात	स्वरूपात

svarupatale	स्वरूपातले	स्वरूपातले

swarupatale	स्वरूपाळले	स्वरूपातले

svarupatahee	स्वरूपाठही	स्वरूपातही

svarupatahi	स्वरूपाठही	स्वरूपातही

swarupatahi	स्वरूपातही	स्वरूपातही

swareecha	स्वररीचा	स्वारीचा

swaricha	स्वीरीचा	स्वारीचा

swareet	स्वारीत	स्वारीत

swarit	स्वारीत	स्वारीत

sveeng	स्वींग	स्विंग

svin	स्वीन	स्विंग

sving	स्वींग	स्विंग

sweeng	स्वींग	स्विंग

swiing	स्वींग	स्विंग

swin	स्वीन	स्विंग

swing	स्वींग	स्विंग

switzerlandchi	स्वीत्री्लंडाी	स्वित्झर्लंडची

shveeft	स्वेफ्ट	स्विफ्ट

shviphta	स्विफ्ट	स्विफ्ट

shweaft	श्वेफ्ट	स्विफ्ट

shweeft	स्वीफ्ट	स्विफ्ट

shwift	स्वीफ्ट	स्विफ्ट

sveaft	स्वीफ्ट	स्विफ्ट

sveeft	स्वीफ्ट	स्विफ्ट

sveepht	स्विफ्ट	स्विफ्ट

svift	स्वीफ्ट	स्विफ्ट

svifta	स्वीफ्ट	स्विफ्ट

sviift	स्वीफ्ट	स्विफ्ट

sviphta	स्वीफ्ट	स्विफ्ट

sweaft	स्वीफ्ट	स्विफ्ट

sweapht	स्वीफ्ट	स्विफ्ट

sweeft	स्वीफ्ट	स्विफ्ट

sweepht	स्वीफ्ट	स्विफ्ट

sweft	स्वीफ्ट	स्विफ्ट

swift	स्वीफ्ट	स्विफ्ट

swiift	स्वीफ्ट	स्विफ्ट

swipht	स्वीफ्ट	स्विफ्ट

swiphta	स्वीफ्ट	स्विफ्ट

shveep	श्वीप	स्वीप

shvipa	स्वीपा	स्वीप

shweap	श्विप	स्वीप

shweep	श्वीप	स्वीप

sveap	स्वीप	स्वीप

sveep	स्वीप	स्वीप

sviip	स्वीप	स्वीप

sviipa	स्वीपा	स्वीप

svipa	स्वीप	स्वीप

sweap	स्वीप	स्वीप

sweep	स्वीप	स्वीप

swep	स्वीप	स्वीप

swiip	स्वीप	स्वीप

swipa	स्वीपा	स्वीप

handaseet	हंडिीत	हँडसेट

handaset	हंडाेत	हँडसेट

handseet	हंडिीत	हँडसेट

handset	हंड््त	हँडसेट

hajaree	हजारी	हजारी

hajari	हजारी	हजारी

harananche	हराांचे	हरणांचे

harnanche	हर्ांचे	हरणांचे

harananchya	हराांच्या	हरणांच्या

harnanchya	हर्ांच्या	हरणांच्या

haranachya	हरााच्या	हरणाच्या

harnachya	हर्ाच्या	हरणाच्या

hari	हरी	हरि

hariche	हरीचे	हरिचे

haree	हरी	हरी

hari	हरी	हरी

harii	हरी	हरी

hary	हॅ्	हरी

hurri	हरी	हरी

hurry	हरी	हरी

hury	हु्	हरी

hardikar	हा्डिकर	हर्डीकर

haladine	हलदीने	हळदीने

haldine	हलदीने	हळदीने

havyat	हव्यात	हव्यात

hasanyachya	हाणायाच्या	हसण्याच्या

hasnyachya	हसण्याच्या	हसण्याच्या

hast	हस्ट	हस्त

haste	हसतटे	हस्ते

hausache	हौससाे	हाऊसचे

houseche	हूससेे	हाऊसचे

hausachya	हौससा्या	हाऊसच्या

housechya	हूससे्या	हाऊसच्या

hatohat	हातोहात	हातोहात

harmonium	हारामिनिकु	हार्मोनियम

harmoniyam	हरर्मननिया	हार्मोनियम

harmoniyama	हरर्मिनिया	हार्मोनियम

harmoonium	हरर्मिहिकु	हार्मोनियम

harmooniyama	हरर्मननिका	हार्मोनियम

harmoniumvar	हरर्मिहिमुरर	हार्मोनियमवर

harmoniyamvar	हरर्मणणियारर	हार्मोनियमवर

hindavi	हिंदवी	हिंदवी

hindvi	हिंदवी	हिंदवी

hindusthanat	हिंदुस्ताततत	हिंदुस्थानात

hindusthanateel	हिंदुस्थातातील	हिंदुस्थानातील

hindusthanatil	हिंदुस्थातातील	हिंदुस्थानातील

hichyakade	हिख्याकडे	हिच्याकडे

hichyavar	हिच्यावर	हिच्यावर

hichyavr	हिच्यावर	हिच्यावर

heatlar	हेतरर	हिटलर

heatler	हिलरर	हिटलर

heetlar	हिटरर	हिटलर

heetler	हिलरर	हिटलर

hetler	हॅटलर	हिटलर

hiitler	हिलरर	हिटलर

hitalar	हितार	हिटलर

hitalara	हिटलर	हिटलर

hitler	हितलर	हिटलर

hittlar	हितलर	हिटलर

hittler	हितलर	हिटलर

hitalarachya	हितारा्या	हिटलरच्या

hitlerchya	हितलरच्या	हिटलरच्या

hitalarala	हितारला	हिटलरला

hitlerla	हिटलरला	हिटलरला

hitchintak	हित्िनकक	हितचिंतक

hindoo	हिं्दू	हिन्दू

hindu	हिं्दू	हिन्दू

himalayacha	हिमालयाचा	हिमालयाचा

himalayachi	हिमालयाची	हिमालयाची

himalayachya	हिमालयाच्या	हिमालयाच्या

hiil	हिल	हिल

hil	हिल	हिल

hill	हिल	हिल

hivalyateel	हिवाळ्यातील	हिवाळ्यातील

hivalyatil	हिवाळ्यातील	हिवाळ्यातील

heechee	हिची	हीची

heechi	हिची	हीची

hichi	हिची	हीची

hundaka	हुंडका	हुंदका

husharee	हुशारी	हुशारी

hushari	हुशारी	हुशारी

hushareene	हुसररीने	हुशारीने

husharine	हुरररिने	हुशारीने

hratik	ह्तिक	हृतिक

hritik	हृतिक	हृतिक

hrutik	हृतिक	हृतिक

hrishikesh	ऋृषिकेश	हृषिकेश

hrusheekesh	ऋृषिकेश	हृषिकेश

hrushikesh	ऋृषिकेश	हृषिकेश

hay	हय	हे

he	हे	हे

hei	हे	हे

hey	हे	हे

hetoone	हेतूने	हेतुने

hetune	हेतूने	हेतुने

herat	हररात	हेरात

harald	हॅरलल	हेराल्ड

haralda	हररललाड	हेराल्ड

heerald	हिरलल	हेराल्ड

heeralda	हिरलल	हेराल्ड

herald	हॅरलल	हेराल्ड

heralda	हिरलल	हेराल्ड

heroon	हररून	हेरून

herun	हररून	हेरून

hesuddha	हेसुद्धा	हेसुद्धा

haland	हललंड	हॉलंड

halland	हललंड	हॉलंड

hauland	हॉलंड	हॉलंड

holand	होलंड	हॉलंड

holland	होलंड	हॉलंड

ho	हो	हो

hoe	होई	हो

hoo	हो	हो

hooe	हो	हो

hoowe	होवे	हो

hove	होवे	हो

howe	होवा	हो

hotatach	होताता	होतातच

hotee	होती	होती

hoti	होती	होती

homehavan	होमहीन	होमहवन

homhavan	होमाान	होमहवन

hyanchyateel	ह्यांच्यातील	ह्यांच्यातील

hyanchyatil	ह्यांत्यातील	ह्यांच्यातील

hyannee	ह्यांनी	ह्यांनी

hyanni	ह्यांनी	ह्यांनी

hyanneech	ह्यांनीच	ह्यांनीच

hyannich	ह्यांनीच	ह्यांनीच

