andarasan	आंडरसन	अँडरसन

andarasana	आंडरसन	अँडरसन

andarashana	अंडर्ा	अँडरसन

andarsan	अंडर्न	अँडरसन

andarsen	अंडर्न	अँडरसन

andarson	अंडर्न	अँडरसन

andersan	अंडर्न	अँडरसन

andersen	अंडर्न	अँडरसन

andershon	अंडर्न	अँडरसन

anderson	अंडर्न	अँडरसन

undarson	उंडर्न	अँडरसन

undersan	यंडर्न	अँडरसन

undershon	यंडर्न	अँडरसन

underson	यंडर्न	अँडरसन

ankoor	अँकोर	अंकुर

ankur	अंकूर	अंकुर

ankurit	अंकुरीत	अंकुरित

angai	अंगयई	अंगाई

angarakee	अंगारकी	अंगारकी

angarkee	अंगररकी	अंगारकी

angarki	अंगररकी	अंगारकी

aintartic	अँतरर्टिटिक	अंटार्क्टिक

aintartik	अंतरर्टिटिक	अंटार्क्टिक

aintartiq	अँतरर्टिटिक	अंटार्क्टिक

antarktika	अंतररककतटिक	अंटार्क्टिक

antarqtiqa	अंतररकक्टिक	अंटार्क्टिक

antartic	अँतरर्टिटिक	अंटार्क्टिक

entartic	अंटरर्टिटिक	अंटार्क्टिक

entartik	अंतरर्टिटिक	अंटार्क्टिक

antarangacha	अंतरागाचा	अंतरंगाचा

antarman	अंतर्मन	अंतर्मन

antarmanat	अंतर्माात	अंतर्मनात

antarmukh	अंतर्मुख	अंतर्मुख

antee	अंती	अंती

anti	अँती	अंती

antharunala	अंथरूनाला	अंथरुणाला

anthroonala	अंथरूनाला	अंथरुणाला

anthrunala	अंथरूनाला	अंथरुणाला

andhakaarmay	अंधकार्या	अंधकारमय

andhakaramay	अंधकाराया	अंधकारमय

andhakarmay	अंधकार्या	अंधकारमय

andhkarmay	अंधकार्य	अंधकारमय

ambar	अंबर	अंबर

ambara	ऑंबर	अंबर

amber	आंबर	अंबर

ambarat	अंबरात	अंबरात

aksh	अक्ष	अक्ष

akshamya	अक्षम्य	अक्षम्य

akshmy	आक्ष््य	अक्षम्य

akshyamya	अक्ष््य	अक्षम्य

aksharashah	अक्षरशह	अक्षरशः

aksharashaha	अक्षरशह	अक्षरशः

aksharksha	अक्षर््	अक्षरशः

agadi	अगाी	अगदी

agdi	अगदी	अगदी

agadeech	अगिीच	अगदीच

agdeech	अगडीच	अगदीच

agdich	अगडीच	अगदीच

agr	आग्र	अग्र

agra	आग्र	अग्र

achook	अचूक	अचुक

achuk	अचूक	अचुक

achookta	अचुक्ा	अचुकता

achukata	अचुकता	अचुकता

achukta	अचुक्ा	अचुकता

ajinkyapad	अजिंक्यपद	अजिंक्यपद

ajeet	अजीत	अजित

ajiit	अजित	अजित

ajit	अजीत	अजित

ajita	अजिता	अजित

azeet	अझीत	अजित

azit	अझीत	अजित

azita	अझिता	अजित

ajitdada	अझितददद	अजितदादा

atakav	आटकाव	अटकाव

atkaav	आटकाव	अटकाव

adachan	आडचा	अडचण

adchan	अडचा	अडचण

adathala	अडथळा	अडथळा

adavale	अडवले	अडवले

atishay	अतिशा	अतिशय

atishaya	अतिशा	अतिशय

atyalp	अत्यल्प	अत्यल्प

atyalpa	अट्या्पा	अत्यल्प

adrushy	अदृष्य	अदृश्य

adrushya	अदृष्य	अदृश्य

adhikach	अधिकच	अधिकच

adhikch	अधीकच	अधिकच

adhikachya	अधिका्या	अधिकच्या

adhikchya	अधीकच्या	अधिकच्या

adhikaat	अधिकात	अधिकात

adhikat	अधिकतत	अधिकात

adhiniyamachya	अधिनीयााच्या	अधिनियमाच्या

adhiniyamat	अधिन्यातत	अधिनियमात

adhiniyamateel	अधिनीयाातील	अधिनियमातील

adhiniyamatil	अधिनीयाातील	अधिनियमातील

adhikshak	अधिक्षक	अधीक्षक

adhyakshannee	अध्यक्षांनी	अध्यक्षांनी

adhyakshanni	अध्यक्षांनी	अध्यक्षांनी

adhyakshache	अध्यक्षाचे	अध्यक्षाचे

adhyaksheey	अध्यक्षीय	अध्यक्षीय

adhyakshiy	अध्यक्षीय	अध्यक्षीय

adhyapan	अध्यापा	अध्यापन

adhyapanachee	अध्यपपनाची	अध्यापनाची

adhyapanachi	अध्यपपनाची	अध्यापनाची

adhyapanachya	अध्यापनाच्या	अध्यापनाच्या

adhyay	अध्ययय	अध्याय

adhyayat	अध्याततत	अध्यायात

ananas	अनाा	अननस

anabhishikt	अनभिषिक्त	अनभिषिक्त

anabhishikta	अनभिषिक्त	अनभिषिक्त

anbhishikt	अंभिषिक्त	अनभिषिक्त

anathalay	अनाठालय	अनाथालय

anavadhanane	अनववधानाने	अनावधानाने

anavdhanane	अनावधानाने	अनावधानाने

anavaran	अनावरण	अनावरण

anutsuk	अनुत्सुक	अनुत्सुक

anooyayancha	अनूयायांचा	अनुयायांचा

anuyaayancha	अनुयायांचा	अनुयायांचा

anuyayancha	अनुयायांचा	अनुयायांचा

anooyayanche	अनुयायांचे	अनुयायांचे

anuyaayanche	अनुयायांचे	अनुयायांचे

anuyayanche	अनुयांांचे	अनुयायांचे

anooyayanna	अनुयायांना	अनुयायांना

anuyaayanna	अनुयायांना	अनुयायांना

anuyayanna	अनुयायांना	अनुयायांना

anooyayee	अनुयायी	अनुयायी

anuyaayi	अनुयायी	अनुयायी

anuyayee	अनुयायी	अनुयायी

anuyayi	अनुयीयी	अनुयायी

anuvad	अनुवाद	अनुवाद

anuvadahi	आनुवादही	अनुवादही

anuvadhee	अनुवाढीी	अनुवादही

anuvadache	आनुवादाचे	अनुवादाचे

anuvadachya	आनुवादाच्या	अनुवादाच्या

anuvadasathee	अनुवादासाठी	अनुवादासाठी

anuvadasathi	अनुवादासाठी	अनुवादासाठी

apatye	अपत्ये	अपत्ये

aparaadh	अपराध	अपराध

aparadh	अपरडध	अपराध

aparadhachee	अपााधाची	अपराधाची

aparadhachi	अपराधाची	अपराधाची

aparadhee	अपााधी	अपराधी

aparadhi	अपााधी	अपराधी

apavyay	अपव्या	अपव्यय

apuree	अपुरी	अपुरी

apuri	अपुरी	अपुरी

apoorva	अपूर्व	अपूर्वा

apurva	अपूर्व	अपूर्वा

afaganistan	अफगननीस्तान	अफगाणिस्तान

afghanistan	अफ्नयीत्तान	अफगाणिस्तान

afaganistancha	अफगननीस्तांचा	अफगाणिस्तानचा

afghanistancha	अफ्िसीत्तांचा	अफगाणिस्तानचा

afaganistanchya	अफगननीत्तांच्या	अफगाणिस्तानच्या

afghanistanchya	अफगिसीत्तांच्या	अफगाणिस्तानच्या

afaganistanmadheel	अफगननीस्तांमधील	अफगाणिस्तानमधील

afghanistanmadhil	अफगिसीत्तांाधील	अफगाणिस्तानमधील

afaganistanmadhye	अफगननीस्तां्ध्ये	अफगाणिस्तानमध्ये

afghanistanmadhye	अफगिसीत्तांाध्ये	अफगाणिस्तानमध्ये

afaganistanla	अफगननीस्तांल	अफगाणिस्तानला

afghanistanala	अफगियीत्तांाा	अफगाणिस्तानला

afghanistanla	अफगियीत्तां	अफगाणिस्तानला

abadhit	अबाधीत	अबाधित

abj	अब्ज	अब्ज

abja	अब्जा	अब्ज

abhiyaan	अभियान	अभियान

abhiyan	अभियान	अभियान

amarapurkar	अमरापूरकर	अमरापूरकर

amrapoorkar	अमृापूरकर	अमरापूरकर

amrapurkar	अमरापूरकर	अमरापूरकर

amaan	अमान	अमान

amanat	अमाना	अमानत

aroonkumar	ऑरुंकुमार	अरुणकुमार

arunkumar	अरुंकुमार	अरुणकुमार

aroona	ऍरूना	अरुणा

aruna	अरूणा	अरुणा

arunaa	अरूणा	अरुणा

arc	आर्क	अर्क

ark	ओर्क	अर्क

alabama	अलाबाम	अलाबामा

albama	अल्म्म	अलाबामा

ulbama	उल्म्म	अलाबामा

altra	अल्त्र	अल्ट्रा

ultra	उल्त्र	अल्ट्रा

alpasankhyakanche	अल्पसंख्यकंानचे	अल्पसंख्याकांचे

alpsankhyakanche	अल्पसंख्यकंांचे	अल्पसंख्याकांचे

alpsankyakanche	अल्पसंक्यकंांचे	अल्पसंख्याकांचे

alpavadhit	अल्पववधीत	अल्पावधीत

alpvadheet	अल्पवधधीत	अल्पावधीत

alpavadhitach	अल्पववधितच	अल्पावधीतच

alpavadhitacha	अल्पववधितचा	अल्पावधीतच

alpopahar	अल्पोपारर	अल्पोपहार

alpophaar	अल्पोफफार	अल्पोपहार

alpophar	ऑल्पोफररर	अल्पोपहार

avakala	अवकला	अवकळा

avakalha	अवकलह	अवकळा

avkalaa	अवकला	अवकळा

avakashyan	अवकाश्नन	अवकाशयान

avkaashyan	अवकाश्नन	अवकाशयान

avkashayan	अवकाशयनन	अवकाशयान

avkashyan	अवकाश्नन	अवकाशयान

avayav	अवया	अवयव

awayaw	अवया	अवयव

avayavanchi	अवयाांची	अवयवांची

avayawanchi	अवयाांची	अवयवांची

avyavanchi	अव्ाांची	अवयवांची

awayawanchi	अवयाांची	अवयवांची

avayavanche	अवयाांचे	अवयवांचे

avayawanche	अवयाांचे	अवयवांचे

avyavanche	अव्ाांचे	अवयवांचे

awayawanche	अवयवांचे	अवयवांचे

avayavanchya	आवयवांच्या	अवयवांच्या

avayawanchya	आवयवांच्या	अवयवांच्या

avyavanchya	आव्ाांच्या	अवयवांच्या

awayawanchya	आवयवांच्या	अवयवांच्या

avayavanna	अवयवांना	अवयवांना

avayawanna	अवयवांना	अवयवांना

avyavanna	आव्वांना	अवयवांना

awayawanna	अवयवांना	अवयवांना

award	आवरर्ड	अवार्ड

ashikshit	अशिक्षित	अशिक्षित

asam	आसा	असं

asn	असं	असं

asanch	असंच	असंच

asantulit	असंतुलीत	असंतुलित

asahi	असहही	असंही

asanhi	असनही	असंही

asat	असत	असत

asatya	असत्या	असत्या

asatyaa	असत्या	असत्या

astya	असत्या	असत्या

asalee	असली	असली

asali	असली	असली

asli	असली	असली

asalelee	असलेली	असलेली

asleli	असलेली	असलेली

asalele	असलेले	असलेले

aslel	असलेल	असलेले

aslele	असलेले	असलेले

asalelya	असलेल्या	असलेल्या

aslalaya	असलालाया	असलेल्या

aslelya	असलेल्या	असलेल्या

asahay	असहाय	असहाय

ashaya	अशायय	असहाय

asaadhy	असाध्य	असाध्य

asadhaya	असाधाया	असाध्य

asadhy	असाध्य	असाध्य

asava	असववा	असावा

asaavi	असावी	असावी

asavee	असावी	असावी

asavi	असावी	असावी

asaavit	असावित	असावीत

asaveet	असववित	असावीत

asavit	असववित	असावीत

asave	असावे	असावे

asavet	असावेत	असावेत

aseef	असीफ	असिफ

asif	आसिफ	असिफ

asiph	असिफ	असिफ

asoonasuddha	असुनसुद्ध	असूनसुद्धा

asoonsuddha	असुनसुद्ध	असूनसुद्धा

asunsuddha	असुनसुद्ध	असूनसुद्धा

astanantar	अस्तानातर	अस्तानंतर

astitv	अस्तित्व	अस्तित्व

astitva	अस्तित्त	अस्तित्व

astitvach	असततित्ता	अस्तित्वच

astitvacha	अस्तित्ताचा	अस्तित्वाचा

astitvachee	अस्तित्ताची	अस्तित्वाची

astitvachi	अस्तित्ताची	अस्तित्वाची

astitvateel	अस्तित्तातील	अस्तित्वातील

astitvatil	अस्तित्तातील	अस्तित्वातील

asthayi	असथथायी	अस्थायी

asmita	अस्मिता	अस्मिता

ahamadabadchya	अहमदाबादच्या	अहमदाबादच्या

ahemdabadchya	अहंदाबादच्या	अहमदाबादच्या

ahmedabadchya	अहमदाबादच्या	अहमदाबादच्या

ahamadabadla	अहमदाबादला	अहमदाबादला

ahemadabadla	अहमााबादला	अहमदाबादला

ahmadabadla	अहमदाबादला	अहमदाबादला

aaikadoon	आइकडून	आईकडून

aaikadun	आइकडून	आईकडून

aaichee	आईची	आईची

aaichi	आईची	आईची

aaichya	आईच्या	आईच्या

aaila	आईला	आईला

aakarmanacha	आक्रमानाचा	आकारमानाचा

kakarmanacha	कक्र्ानाचा	आकारमानाचा

aakarmanachi	आक्रमानाची	आकारमानाची

aakarmanane	आक्रमानाने	आकारमानाने

aakrutya	आकृत्य	आकृत्या

aagade	आगळे	आगळे

aagale	आगळे	आगळे

aagle	आगळे	आगळे

aagekooch	आगीकचच	आगेकूच

aagekuch	आगेकचच	आगेकूच

aajatagayat	आजाागायत	आजतागायत

aajtagayat	आज्ागायत	आजतागायत

aajaranche	आजररांचे	आजारांचे

ajaranche	आजररांचे	आजारांचे

aajaranchya	आजररांच्या	आजारांच्या

ajaranchya	आजररांच्या	आजारांच्या

aajaranmaddhe	आजररांमध्ये	आजारांमध्ये

aajaranmadhye	आजररांमध्ये	आजारांमध्ये

aajaransathi	आजारांसाठी	आजारांसाठी

aajarakade	आजाराकडे	आजाराकडे

ajarakade	आजरराकडे	आजाराकडे

aajarachi	आजरराची	आजाराची

ajarachi	आजरराची	आजाराची

aajarachya	आजरराच्या	आजाराच्या

aajarachyaa	आजरराच्या	आजाराच्या

ajarachya	अजरराच्या	आजाराच्या

aajaraat	आजररात	आजारात

aajarat	आजररतत	आजारात

ajarat	अजररतत	आजारात

aajaramadhye	आजररामध्ये	आजारामध्ये

ajaramadhye	आजररामध्ये	आजारामध्ये

aajaramule	आजररामुळे	आजारामुळे

ajaramule	आजररामुळे	आजारामुळे

aajarala	आजरराला	आजाराला

ajarala	आजरराला	आजाराला

aajaaree	आजारी	आजारी

aajaari	आजारी	आजारी

aajari	आजररी	आजारी

aajoobajooche	आजूबाजूचे	आजूबाजूचे

aajubajuche	आजुबाजूचे	आजूबाजूचे

aajoobajoochya	आजुबाजूच्या	आजूबाजूच्या

aajubajuchya	आजुबाजुच्या	आजूबाजूच्या

aajunajuchya	आजुनाजूच्या	आजूबाजूच्या

aajobanchee	आजोबांची	आजोबांची

aajobanchi	आजोबांची	आजोबांची

aajobanche	आजोबांचे	आजोबांचे

aajobanchya	आजोबांच्या	आजोबांच्या

aath	आठ	आठ

aanlela	आणलेला	आणलेला

aanalele	आणलेले	आणलेले

aanlele	आणलेले	आणलेले

anlele	अणलेले	आणलेले

aanave	आणववे	आणावे

anawe	अणववे	आणावे

aanee	आणी	आणि

aani	आणी	आणि

ani	अणी	आणि

aanel	आणेल	आणेल

aatade	आतडे	आतडे

aadim	आदिम	आदिम

aadee	आदि	आदी

aadi	आदि	आदी

aadii	आदी	आदी

adee	अदि	आदी

adi	एदी	आदी

adii	एडी	आदी

aan	आण	आन

aanandajee	आनंदाी	आनंदजी

anandajee	अनंदाी	आनंदजी

anandji	अनंदीी	आनंदजी

aapaapsat	आपापसात	आपआपसात

aapaapsath	आपापसाठ	आपआपसात

aapasat	आपाात	आपसात

aapsaat	आपसात	आपसात

aamuchi	आमुची	आमुची

aamuchy	आमुच्	आमुची

aamhee	आम्ही	आम्ही

aamhi	आम्ही	आम्ही

aaryan	आरा्य	आयर्न

aayarn	आयर्न	आयर्न

aryan	अरा्य	आयर्न

ayarn	अयर्न	आयर्न

iran	इयराय	आयर्न

iron	एयरोन	आयर्न

aayaland	आयलंड	आयलंड

iceland	आयर्डॉ	आयलंड

iland	आयलंड	आयलंड

island	आयस्ड	आयलंड

ayoniyan	आयोनियन	आयोनियन

ayooniyan	आयोनियन	आयोनियन

ionan	आयननियन	आयोनियन

ionian	आयननियन	आयोनियन

ioonian	आयननियन	आयोनियन

aayova	आयोवा	आयोवा

ayoova	आयो	आयोवा

ayoowa	आयो	आयोवा

ayova	आयोवा	आयोवा

ayowa	आयो	आयोवा

ioova	यवो	आयोवा

ioowa	यवो	आयोवा

iova	ओवो	आयोवा

iowa	ओवो	आयोवा

aaramsheer	आरामशीर	आरामशीर

aaramshir	आरामशीर	आरामशीर

aarteemis	आर्टिमिस	आर्टेमिस

aartemis	आर्टेमिस	आर्टेमिस

arteemeeas	ऑर्टिमिस	आर्टेमिस

arteemis	ऑर्टिमिस	आर्टेमिस

artemeas	ऑर्टेमिस	आर्टेमिस

artemes	ऑर्टममिस	आर्टेमिस

artemis	ऑर्टेमिस	आर्टेमिस

aarthik	आर्थिक	आर्थिक

aarseenal	आर्सिनल	आर्सेनल

aarsenal	आर्सननल	आर्सेनल

aarshenal	आर्षेनल	आर्सेनल

arseenala	अर्सेनला	आर्सेनल

arsenala	अर्सेनला	आर्सेनल

arshenala	अर्शेनला	आर्सेनल

aala	आलं	आला

aalo	आलो	आलो

alo	ऑलो	आलो

aavaka	आवकका	आवाका

aavruttee	आवृत्ती	आवृत्ती

aavrutti	आवृत्ती	आवृत्ती

avrutti	अवृत्ती	आवृत्ती

aavritichay	आवृतीयीचे	आवृत्तीचे

aavruttiche	आवृत्तीचे	आवृत्तीचे

aawritichay	आवृतीचीचे	आवृत्तीचे

avruttiche	अवृत्तीचे	आवृत्तीचे

aavrateet	आव्तीती	आवृत्तीत

aavriteet	आवृतीतीत	आवृत्तीत

aavruttit	आवृत्तीत	आवृत्तीत

avruttit	अवृत्तीत	आवृत्तीत

aashevar	आशेवर	आशेवर

ashevar	अशेवर	आशेवर

aashta	आष्ट	आष्टा

ashta	अष्ट	आष्टा

aasaram	आसरराम	आसाराम

asaram	असरराम	आसाराम

asarama	आसररममा	आसाराम

aahaat	आहात	आहात

aahat	आहतत	आहात

ahaat	अहात	आहात

aahaar	आहार	आहार

aahar	आहरर	आहार

ahaar	अहार	आहार

aahaarakaday	आहारककडा	आहाराकडे

aahaarakade	आहाराकडे	आहाराकडे

aaharakade	आहाराडडे	आहाराकडे

aahaarachay	आहारचचय	आहाराचे

aaharache	आहाराचे	आहाराचे

ahaarache	अहाराचे	आहाराचे

aaharat	आहररतत	आहारात

ahaarat	अहारतत	आहारात

aahet	आहेतः	आहेत

engraj	इंग्रज	इंग्रज

ingraj	इंग्रज	इंग्रज

ingrej	इंग्रे	इंग्रज

engrajancha	इंग्रजांचा	इंग्रजांचा

engrajanchi	इंग्रजांची	इंग्रजांची

engrajanche	इंग्रजांचे	इंग्रजांचे

engrajanna	इंग्रजांना	इंग्रजांना

engrajache	इंग्रजाचे	इंग्रजाचे

ingrajache	इंग्रजाचे	इंग्रजाचे

englandakadoon	इंगललनडकडून	इंग्लंडकडून

englandkadoon	एंगळलाडकडून	इंग्लंडकडून

englandkadun	एंगललाडकडून	इंग्लंडकडून

englandchya	इंगललंडच्या	इंग्लंडच्या

englandne	एंगंलनड	इंग्लंडने

englandmadheel	इंगललादमधील	इंग्लंडमधील

englandmadhil	इंगललाडमधील	इंग्लंडमधील

englandla	इंगललंड	इंग्लंडला

endaus	एंदू	इंडस

endous	इंदू	इंडस

endoush	इंदू	इंडस

endus	एंडस	इंडस

endush	इंदस	इंडस

indas	आंडस	इंडस

indasa	इंडा	इंडस

indasha	इंडे	इंडस

indos	इंडो	इंडस

indosh	इंदो	इंडस

indus	इंडस	इंडस

indush	इंदस	इंडस

indeeks	एंडेक्स	इंडेक्स

indeex	इंडेक्स	इंडेक्स

indeks	एंडेक्स	इंडेक्स

indeqs	एंडेक्स	इंडेक्स

index	इंडेक्स	इंडेक्स

eendoneeshian	इंडोनिशियन	इंडोनेशियन

eendoneesian	इंडोनिशियन	इंडोनेशियन

endonesan	एंडोनिशनयन	इंडोनेशियन

endoneshan	इंदोनेशनयन	इंडोनेशियन

endoneshhian	इंडोनेशियन	इंडोनेशियन

endoneshian	इंडोनेशियन	इंडोनेशियन

endonesian	इंडोनेशियन	इंडोनेशियन

endooneshian	इंदोनेशियन	इंडोनेशियन

endoonesian	इंडोनिशियन	इंडोनेशियन

indoneeshian	इंडोनिशियन	इंडोनेशियन

indoneeshiyan	इंडोनिशियन	इंडोनेशियन

indoneshan	इंडोनेशनयन	इंडोनेशियन

indoneshhian	इंडोनेशियन	इंडोनेशियन

indoneshhiyan	इंडोनेशियन	इंडोनेशियन

indoneshian	इंडोनेशियन	इंडोनेशियन

indoneshiyan	इंडोनेशियन	इंडोनेशियन

indonesian	इंडोनेशियन	इंडोनेशियन

indonesiyan	इंडोनेशियन	इंडोनेशियन

indooneshian	इंडोनेशियन	इंडोनेशियन

indooneshiyan	इंडोनेशियन	इंडोनेशियन

indapoor	इंदापूर	इंदापूर

indapur	इंदापूर	इंदापूर

indrajit	इंद्रजीत	इंद्रजित

ekbal	एकबबलल	इक्बाल

eqbal	एकबबलल	इक्बाल

ikbal	एकबबलल	इक्बाल

ikbala	एकबबाला	इक्बाल

iqbal	इकबबलल	इक्बाल

iqbala	इकबबाला	इक्बाल

igatapuree	इगतपुरी	इगतपुरी

igatpuree	इगतपुरी	इगतपुरी

igatpuri	इगतपुरी	इगतपुरी

egoor	एगरर	इगोर

egor	एजरर	इगोर

igoor	आगूर	इगोर

igor	यजरर	इगोर

itaki	इटकी	इतकी

itki	इतकी	इतकी

inaayat	इनायत	इनायत

inayat	इनायट	इनायत

institute	इन्स्टिट्ूट	इन्स्टिटयूट

instityoot	इन्स्टिट्ूट	इन्स्टिटयूट

emraan	इमरान	इमरान

imaran	इमाान	इमरान

imran	इमरान	इमरान

iyatta	आयट्त	इयत्ता

ear	एअर	इयर

er	एरर	इयर

iyar	अयर	इयर

year	यअर	इयर

yer	यरर	इयर

ilakhyaat	आिाख्यात	इलाख्यात

ilakhyat	आिाख्यात	इलाख्यात

ishhk	आश्क	इश्क

ishhq	आश्क	इश्क

ishk	आश्क	इश्क

ishq	आश्क	इश्क

isk	एस्क	इश्क

isq	एस्क	इश्क

essence	एसान्स	इसेन्स

isens	एसेन्स	इसेन्स

israel	इस्रायल	इस्राईल

israil	इस्रायल	इस्राईल

eeshanyela	ईशान्येला	ईशान्येला

ishanyela	इशान्येला	ईशान्येला

eeshwarachya	एश्वराच्या	ईश्वराच्या

ishwarachya	इश्वराच्या	ईश्वराच्या

ishvareey	इश्वरीय	ईश्वरीय

ishwariy	इश्वरीय	ईश्वरीय

ishwariya	इश्वाीय	ईश्वरीय

ugavan	उगवा	उगवण

ugawan	उगवा	उगवण

ugr	उग्र	उग्र

ugra	उग्र	उग्र

uddanpool	उद्दांपूल	उड्डाणपूल

uddanpul	उद्दांपूल	उड्डाणपूल

utarati	उतरती	उतरती

utarave	उतरावे	उतरावे

uttar	उत्तर	उत्तर

uttarakashi	उत्तरााशी	उत्तरकाशी

uttarkashi	उत्तर्ाशी	उत्तरकाशी

uttarahee	उत्तरही	उत्तरही

uttarahi	उत्तरही	उत्तरही

uttarhee	उत्तरही	उत्तरही

uttara	उत्तरा	उत्तरा

uttarachya	उत्तराच्या	उत्तराच्या

uttareeya	उत्तरीय	उत्तरीय

uttariy	उत्तरीय	उत्तरीय

uttariya	उत्तरिय	उत्तरीय

utpad	उत्पाद	उत्पाद

utsavachee	उत्सवाची	उत्सवाची

utsavachi	उत्सवाची	उत्सवाची

utsavache	उत्सवाचे	उत्सवाचे

utsavat	उत्सवात	उत्सवात

utsavateel	उत्सवातील	उत्सवातील

utsavatil	उत्सवततील	उत्सवातील

utsavane	उत्सवाने	उत्सवाने

utsavala	उत्सवलला	उत्सवाला

udya	उद्य	उद्या

udyachya	उद्याच्या	उद्याच्या

udyogpatee	उद्योगपती	उद्योगपती

udyogpati	उद्योगपती	उद्योगपती

udhaan	उधाण	उधाण

udhan	उधाण	उधाण

unnaticha	उन्नतीचा	उन्नतीचा

upagrahachi	उपग्रहाची	उपग्रहाची

upgrahachi	उपग्रहाची	उपग्रहाची

upagrahache	उपग्रहाचे	उपग्रहाचे

upgrahache	उपग्रहाचे	उपग्रहाचे

upagrahachya	उपग्रहाच्या	उपग्रहाच्या

upgrahachya	उपग्रहाच्या	उपग्रहाच्या

upanam	उपनंम	उपनाम

upnam	उपनाम	उपनाम

upayogansathee	उपयोगंंसाठी	उपयोगांसाठी

upyogansaathi	उपयोगांसाठी	उपयोगांसाठी

upyogasathi	उपयोगासताठी	उपयोगांसाठी

upayogacha	उपयोगाचा	उपयोगाचा

upyogacha	उपयोगाचा	उपयोगाचा

upayogachya	उपयोगाच्या	उपयोगाच्या

upyogachya	उप्ोगाच्या	उपयोगाच्या

upayogat	उपयोगात	उपयोगात

upyogat	उपयोगात	उपयोगात

upayogee	उपयोगी	उपयोगी

upayogi	उपयोगी	उपयोगी

upyogi	उपयोगी	उपयोगी

uparollekhit	उपरोल्लेखित	उपरोल्लेखित

uprollekhit	उप्ोल्लेखित	उपरोल्लेखित

upasarg	उपसर्ग	उपसर्ग

upsarg	उपसर्ग	उपसर्ग

ubhay	उभय	उभय

ubhayatannee	उभयटांनी	उभयतांनी

ubhayatanni	उभयटांनी	उभयतांनी

ubhaytanni	उभयतांनी	उभयतांनी

ubhe	उभे	उभे

ubhech	उभेच	उभेच

aamesh	आमेश	उमेश

oomeesh	ओमिश	उमेश

oomes	ओमसस	उमेश

oomesh	ओमेश	उमेश

oomeshh	ओम्श	उमेश

umeesh	उमिश	उमेश

umes	उम्श	उमेश

umesh	उमेश	उमेश

umeshh	उमेश	उमेश

urdoo	उर्डू	उर्दू

urdu	उरडडु	उर्दू

urduu	उरूदू	उर्दू

uurdoo	उर्दू	उर्दू

uurduu	उरुदू	उर्दू

urdoocha	यर्दूचा	उर्दूचा

urducha	उर्दूचा	उर्दूचा

ulagadat	उलगडा	उलगडत

ualagadale	उलगडले	उलगडले

ulagadale	उलगडले	उलगडले

ulagadoon	उलगडून	उलगडून

ulagadun	उलगडून	उलगडून

ushnata	उष्णता	उष्णता

usake	उसके	उसके

usmania	उस्मानिया	उस्मानिया

usmaniya	उस्मननिया	उस्मानिया

usatod	उसतोड	ऊसतोड

ustod	उस्ोड	ऊसतोड

usatodanee	उसतोदाी	ऊसतोडणी

ustodanee	उस्ोदाी	ऊसतोडणी

ustodani	उस्ोदाी	ऊसतोडणी

ekandar	एकाडर	एकंदर

ekndar	एकंदर	एकंदर

ektis	एकटीस	एकतीस

eknath	एकनाथ	एकनाथ

ekanathanche	एकााथांचे	एकनाथांचे

eknathanche	एकनाथांचे	एकनाथांचे

ekanathanchya	एकनाठांच्या	एकनाथांच्या

eknathanchya	एकनाथांच्या	एकनाथांच्या

eknishth	एकनिष्ठ	एकनिष्ठ

eknishtha	एकणिष्ठ	एकनिष्ठ

eknishthata	एकनिष्ठता	एकनिष्ठता

ekmatr	एकमात्र	एकमात्र

ekmatra	एकमात्र	एकमात्र

edamantan	एदमंतन	एडमंटन

edmantan	एजमंटन	एडमंटन

edmanton	एजमंटन	एडमंटन

edmonton	एड्नटन	एडमंटन

idamantan	इदांटन	एडमंटन

idmanton	एदिनटन	एडमंटन

idmonton	एडिनटन	एडमंटन

idmuntan	एड््टन	एडमंटन

idmunton	एड्नटन	एडमंटन

ma	ममी	एमए

aevadha	एवढा	एवढा

evadha	एवढा	एवढा

aseen	असिन	एसेन

asen	असनन	एसेन

asieen	असिन	एसेन

asien	असिन	एसेन

asiin	असिन	एसेन

asin	असिन	एसेन

eeseen	ईसेन	एसेन

eesseen	एसिन	एसेन

esen	एसेन	एसेन

essen	एसिन	एसेन

isin	आसिन	एसेन

issin	इसिन	एसेन

aesti	ऐसटटी	एस्टी

estee	इसटटी	एस्टी

esti	इस्टी	एस्टी

aicchik	ऐक्छिक	ऐच्छिक

aichhik	एच्छिक	ऐच्छिक

eachchhik	ऐच्छिक	ऐच्छिक

aehik	एहिक	ऐहिक

aihik	एहिक	ऐहिक

ehik	एहिक	ऐहिक

oxygenchee	ऑक्स्जेची	ऑक्सिजनची

oxygenchi	ऑक्सिजीची	ऑक्सिजनची

alampic	आलिं्पिक	ऑलिम्पिक

alimpika	अलिं्पिक	ऑलिम्पिक

alimpiqa	अलिं्पिक	ऑलिम्पिक

alyimpic	ऑलिम्पिक	ऑलिम्पिक

alympic	ऑलिं्पिक	ऑलिम्पिक

aulampic	ऑलिं्पिक	ऑलिम्पिक

olampic	ऑलिं्पिक	ऑलिम्पिक

olimpik	ऑलिं्पिक	ऑलिम्पिक

olyimpic	ऑलिम्पिक	ऑलिम्पिक

olympic	ऑलिं्पिक	ऑलिम्पिक

aulivhar	ऑलिव्हर	ऑलिव्हर

oliver	ओलिवरहर	ऑलिव्हर

olivhar	ओलिव्हर	ऑलिव्हर

aundaka	औंडका	ओंडका

ondaka	ओंडका	ओंडका

odisa	ओडिसा	ओडिसा

olandala	ओलंंडला	ओलांडला

olandla	ओलांडला	ओलांडला

olandalee	ओळांदीी	ओलांडली

olandali	ओळंंदीी	ओलांडली

olandlee	ओळंंदीी	ओलांडली

ovalanee	ओवाळणी	ओवाळणी

ovalani	ओवळळणी	ओवाळणी

avya	अव्या	ओव्या

ovya	ओव्या	ओव्या

ovyaa	ओव्या	ओव्या

owya	ओव्या	ओव्या

audhyogikeekaran	औद्योगिकीीा	औद्योगिकरण

audyogikaran	औद्योगीकरण	औद्योगिकरण

aushadh	औषा	औषध

aushadhanchya	औषाांच्या	औषधांच्या

aushadhannee	उषाांनी	औषधांनी

aushadhanni	औषाांनी	औषधांनी

aushadhansathee	औषाांसाठी	औषधांसाठी

aushadhansathi	औषाांसाठी	औषधांसाठी

aushadhacha	औषााचा	औषधाचा

aushadhache	औषााचे	औषधाचे

aushadhat	औषाात	औषधात

kangore	कागोर	कंगोरे

kantaloon	कंताळून	कंटाळून

kantalun	कंताळून	कंटाळून

kambarechya	कंबरेच्या	कंबरेच्या

kachara	कचाा	कचरा

kachra	कच्ा	कचरा

kachari	कचारी	कचेरी

kacheree	काेरी	कचेरी

kacharichya	कचाचीच्या	कचेरीच्या

kachereechya	काेरीच्या	कचेरीच्या

kathin	कथीन	कठिण

kada	कदा	कडा

kathak	कथक	कथक

kathakalee	कथकाी	कथकली

kathakali	कथाली	कथकली

kadar	काा	कदर

kanak	काक	कनक

kanada	कॅदअद	कन्नड

kannad	कााना	कन्नड

kannada	कॅानदा	कन्नड

qannada	कॅानदा	कन्नड

kanyaka	कण्याा	कन्यका

kapoorachya	काुरच्या	कपूरच्या

kapoorchya	काूरच्या	कपूरच्या

kapurchya	कपुरच्या	कपूरच्या

kabulee	काुली	कबुली

kabuli	काुली	कबुली

kabr	कब्र	कब्र

kabra	कब्रा	कब्र

kamalakar	काााका	कमलाकर

cammand	कॅंंड	कमांड

comand	कमांड	कमांड

command	कॉंंड	कमांड

commond	कॉोनड	कमांड

comond	कॉंनड	कमांड

kamand	कमांड	कमांड

kamanda	कमांडा	कमांड

kammand	कमंंड	कमांड

qamanda	कमांडा	कमांड

qammand	कमंंड	कमांड

karandikar	काादीकर	करंदीकर

karanaara	करणारा	करणारा

karanara	करणारा	करणारा

karanehee	करणीही	करणेही

karanehi	करणीही	करणेही

karavilee	करविली	करविली

karavili	करविली	करविली

karvilee	करविली	करविली

karachee	कराची	कराची

karachi	कराची	कराची

karachii	कराची	कराची

qarachi	कराची	कराची

karamat	करममत	करामत

karava	करावा	करावा

karu	करू	करु

kareparyant	करेपर्यंत	करेपर्यंत

karna	कर्ना	कर्णा

karnacha	कर्नाचा	कर्णाचा

karnala	कर्नाला	कर्णाला

karnik	का्निक	कर्णिक

kartabagareene	कर्तबगारीने	कर्तबगारीने

kartabgareene	कर्तबगारीने	कर्तबगारीने

kartabgarine	कर्तबगारीने	कर्तबगारीने

karmachya	कर्मचच्या	कर्माच्या

karmat	कर्मठत	कर्मात

karme	कर्म	कर्मे

calar	काा	कलर

calur	कलु	कलर

color	कॉो	कलर

colour	कौा	कलर

colur	कौर	कलर

kalar	काा	कलर

qalar	काा	कलर

kalatani	काातणी	कलाटणी

kaltanee	कल्ताी	कलाटणी

kalika	कािका	कलिका

kalekalene	कलेकाेने	कलेकलेने

kaleklene	कलेकलेने	कलेकलेने

kallol	कलोलोल	कल्लोळ

kalhai	कल्हा	कल्हई

kalapat	कापटत	कळपात

kalalele	कळलेले	कळलेले

kasheli	काेली	कशेळी

kashtachee	कश्टाची	कष्टाची

kashtachi	कश्टाची	कष्टाची

kashtache	कश्टाचे	कष्टाचे

kashtane	का्टाने	कष्टाने

kasabasa	कसबबस	कसाबसा

kasotya	कसोट्या	कसोट्या

concrete	काँक्रेटे	काँक्रिट

konkrit	कोँकररित	काँक्रिट

ka	का	कां

kan	कणण	कां

kanchi	कांची	कांची

canto	कांतो	कांतो

cantoo	कंँतू	कांतो

kanto	कांतो	कांतो

kantoo	काणतू	कांतो

qanto	कांतो	कांतो

kathamandoo	कथठमंंडो	काठमांडू

kathamandu	कथठमंंडू	काठमांडू

kathamanduu	कथठमंंडू	काठमांडू

kathmandu	कथठमांडू	काठमांडू

kathmanduu	कथठमंंडू	काठमांडू

kethamandu	केठमंंडू	काठमांडू

kethmandu	केठमंंडू	काठमांडू

qathamandu	कथठमंंडू	काठमांडू

qathmandu	कथठमांडू	काठमांडू

kadhava	काढववा	काढावा

kanakonakar	कानकोनकर	काणकोणकर

kankonkar	कांकोककर	काणकोणकर

katadee	कटतडी	कातडी

katadi	कटतडी	कातडी

katadeecha	काटदीचा	कातडीचा

katadicha	कतटदीचा	कातडीचा

katal	कातळ	कातळ

katalat	कातातत	कातळात

kapus	कापूस	कापुस

kabadkasht	कबबददकश्ट	काबाडकष्ट

kabadkashta	कबबददकश्ट	काबाडकष्ट

kamothe	कममोठे	कामोठे

kayada	कययदा	कायदा

kayda	कायदा	कायदा

kayadebhang	कायदेभाग	कायदेभंग

kaydebhang	कायदेभाग	कायदेभंग

kayadya	कायद्या	कायद्या

kaydya	कायद्य	कायद्या

kayadyanchi	कायद्यांची	कायद्यांची

kaydyanchee	कायद्यांची	कायद्यांची

kaydyanchi	कायद्यांची	कायद्यांची

kayadyanche	कायद्यांचे	कायद्यांचे

kaydyanche	कायद्यांचे	कायद्यांचे

kayadyanchya	कायद्यांच्या	कायद्यांच्या

kaydyanchya	कायद्यांच्या	कायद्यांच्या

kayadyacha	कायद्याचा	कायद्याचा

kaydyacha	कायद्याचा	कायद्याचा

kayadyachya	कायद्याच्या	कायद्याच्या

kaydyachya	कायद्याच्या	कायद्याच्या

kayadyat	कायद्यात	कायद्यात

kaydyat	कायद्यात	कायद्यात

kayadyane	कायद्याने	कायद्याने

kaydyane	कायद्याने	कायद्याने

kayadyapramane	कायद्यपप्रमाणे	कायद्याप्रमाणे

kaydyapramane	कायद्याप्रमाणे	कायद्याप्रमाणे

kayadyamadhye	कायद्यामध्ये	कायद्यामध्ये

kaydyamadhye	कायद्यामध्ये	कायद्यामध्ये

kayadyamule	कायद्यामुळे	कायद्यामुळे

kaydyamule	कायद्यामुळे	कायद्यामुळे

kayadyala	कायद्याला	कायद्याला

kaydyala	कायद्याला	कायद्याला

kayadyas	कायद्यास	कायद्यास

kaydyas	कायद्यास	कायद्यास

kayam	कॅमम	कायम

kayamach	कायाच	कायमच

kayamch	कायमच	कायमच

kayamachi	कायमाी	कायमची

kayamchee	कायााी	कायमची

kayamchi	कायााी	कायमची

kayamche	कायमचे	कायमचे

karanja	कररंज	कारंजा

karanjee	कररंजी	कारंजी

karanji	कररंजी	कारंजी

karakhandar	कारखंंडार	कारखानदार

karkhandar	कारखंंडार	कारखानदार

karyakartyanche	कार्यकर्त्यांचे	कार्यकर्त्यांचे

karyakartyanna	कार्यकर्त्यांना	कार्यकर्त्यांना

karyakartyanee	कार्यकर्त्याननी	कार्यकर्त्यांनी

karyakartyannee	कार्यकर्त्यांनी	कार्यकर्त्यांनी

karyakartyanni	कार्यकर्त्यांनी	कार्यकर्त्यांनी

karyakaal	कार्यकाळ	कार्यकाल

karyakal	कार्यकलळ	कार्यकाल

karyavaahi	कार्यााही	कार्यवाही

karyavahee	कार्याहही	कार्यवाही

karyavahi	कार्याहही	कार्यवाही

karyalay	कार्यालय	कार्यालय

karyalayache	कार्यालयाचे	कार्यालयाची

karyalayachee	करर्यालयाची	कार्यालयाची

karyalayachi	कार्यालयाची	कार्यालयाची

karyalayaat	कार्यललयात	कार्यालयात

karyalayat	कार्यललयात	कार्यालयात

karyalayateel	कार्यललयातील	कार्यालयातील

karyalayatil	कार्यालयातील	कार्यालयातील

karyalayane	कार्यललयाने	कार्यालयाने

karyalayala	कार्यालयाला	कार्यालयाला

karyalayavar	कार्यललयावर	कार्यालयावर

karyalayawar	कार्यललयावर	कार्यालयावर

karyalayashee	कार्यललयासी	कार्यालयाशी

karyalayashi	कार्यललाासी	कार्यालयाशी

kalava	काळवा	कालवा

kalva	कळळवा	कालवा

kalwa	कळळवा	कालवा

kaliya	कालिया	कालिया

kalapasoon	काळापासून	काळापासून

kalapasun	काळापासून	काळापासून

kaleehee	कालीही	काळीही

kalihee	कालीही	काळीही

kalihi	काळीही	काळीही

kavad	कववड	कावड

kawad	कावड	कावड

kaveel	कववील	कावीळ

kavil	कववील	कावीळ

kasheet	काशीत	काशीत

kashit	काशीत	काशीत

kasavanchee	कससवांची	कासवांची

kasawanchi	कससवांची	कासवांची

kasavanchya	कससवांच्या	कासवांच्या

kasavavnchya	कससवावच्या	कासवांच्या

kasawanchya	कससवांच्या	कासवांच्या

kasavache	कससवाचे	कासवाचे

kasawachi	कससवाची	कासवाचे

kasegao	कासेगाव	कासेगाव

kasegaon	कासेगाव	कासेगाव

kasegav	कासेगाव	कासेगाव

kideenchee	किदींची	किडींची

kideenchi	किदींची	किडींची

kidinchi	किडींची	किडींची

kideenche	किडींचे	किडींचे

kidinche	किडींचे	किडींचे

kinaryala	किनार्याला	किनाऱ्याला

kinaryavar	किनाऱ्यावर	किनाऱ्यावर

kinaryavareel	किनाऱ्यावरील	किनाऱ्यावरील

kinaryavaril	किनाऱ्यावरील	किनाऱ्यावरील

kiranotsargee	किरणोत्सर्गी	किरणोत्सर्गी

kiranotsargi	किरणोत्सर्गी	किरणोत्सर्गी

kisanrao	किसंराव	किसनराव

kisanrav	किसंराव	किसनराव

keertichya	कीर्तीच्या	कीर्तीच्या

kirtichya	कीर्तीच्या	कीर्तीच्या

kundalee	कुंडली	कुंडली

kundali	कुंडाी	कुंडली

kundaleet	कुंडलीत	कुंडलीत

kundalit	कुंडलीत	कुंडलीत

kundlit	कुंडलीत	कुंडलीत

kutoombateel	कुटुंबातील	कुटूंबातील

kutumbateel	कुटुंबातील	कुटूंबातील

kutumbatil	कुटुंबातील	कुटूंबातील

kunakeshvar	कुनकेश्वर	कुणकेश्वर

kunkeshvar	कुनकेश्वर	कुणकेश्वर

kunkeshwar	कुनकेश्वर	कुणकेश्वर

kutuhal	कुटुहल	कुतूहल

kutre	कुत्रे	कुत्रे

kumak	कुमक	कुमक

kumarchya	कुमररच्या	कुमारच्या

kumarne	कुमारणे	कुमारने

kurtakoti	कुर्तकोटी	कुर्तकोटी

kurtkoti	कुर्तकोटी	कुर्तकोटी

kuladeep	कुलदीप	कुलदीप

kuldeep	कुलदीप	कुलदीप

kuldip	कुलदीप	कुलदीप

colabyachya	कललबब्याच्या	कुलाब्याच्या

kulabyachya	कुलबब्याच्या	कुलाब्याच्या

kuloop	कुलूप	कुलूप

kulup	कुलूप	कुलूप

krut	कृत	कृत

kritishil	कृतिशील	कृतीशील

kruteesheel	कृतीशील	कृतीशील

krutishil	कृतिशील	कृतीशील

crupa	क्प	कृपा

kripa	क्प	कृपा

krupa	क्प	कृपा

qripa	क्प	कृपा

qrupa	क्प	कृपा

kripaprasadane	क्पाप्रसादनने	कृपाप्रसादाने

krupaprasadane	कृपाप्रसाननने	कृपाप्रसादाने

krishhna	कृष्ण	कृष्णा

krishna	कृष्ण	कृष्णा

krisna	क्ष्ण	कृष्णा

krushhna	कृष्ण	कृष्णा

krushna	कृष्ण	कृष्णा

krusna	क्स्णा	कृष्णा

qrishna	कृष्ण	कृष्णा

qrushna	कृष्ण	कृष्णा

cancercha	कनन्सर्ा	कॅन्सरचा

camere	कॅमररी	कॅमेरे

caineeth	कॅनीथ	केनेथ

caineth	कॅनाथ	केनेथ

ceneth	केनाथ	केनेथ

keeineeth	किनेथ	केनेथ

keeneeth	किनिठ	केनेथ

keenneeth	किनेठ	केनेथ

keineth	किनाथ	केनेथ

keneth	केनीठ	केनेथ

kenneth	केनेठ	केनेथ

qeineth	किनाथ	केनेथ

qeneth	केनाठ	केनेथ

qenneth	केनेठ	केनेथ

keenyata	किन्यतत	केन्याटा

keenyatta	किण्यतत्	केन्याटा

kenyata	केन्यात	केन्याटा

kenyatta	केण्यतत्	केन्याटा

kenyeta	कॅन्येत	केन्याटा

kenyetta	केन्येत	केन्याटा

qenyata	किन्यात	केन्याटा

qenyatta	केण्यात्	केन्याटा

kaisar	कैसर	कैसर

kaiser	कैशर	कैसर

kaishar	कैशर	कैसर

kaishara	कैशर	कैसर

kaisher	कैशर	कैसर

kesar	केसर	कैसर

kesara	केसर	कैसर

keser	केसर	कैसर

qaisar	कैसर	कैसर

qaisara	कॅसर	कैसर

qaiser	कैशर	कैसर

coimbatore	कोंंबररर	कोइंबतूर

cock	कॉक	कोक

coke	कोक	कोक

kok	कोक	कोक

kokilaben	कोकिलबबेन	कोकिलाबेन

cochin	कोचिन	कोचीन

kocheen	कोचीन	कोचीन

koteenchee	कोटींची	कोटींची

kotinchi	कोटींची	कोटींची

koteepeksha	कोटेपेक्षा	कोटीपेक्षा

kotipeksha	कोटीपेक्षा	कोटीपेक्षा

kothe	कोठे	कोठे

kothech	कोठेच	कोठेच

kothehee	कोठेही	कोठेही

konatahee	कोणतहही	कोणताही

kontahi	कोणतहही	कोणताही

conark	कानार्क	कोणार्क

konark	काणार्क	कोणार्क

kothala	कोठळा	कोथळा

koyaree	कोयरी	कोयरी

koyari	कोयरी	कोयरी

cooria	कोरिया	कोरिया

coorrea	कररेया	कोरिया

corea	कोरिया	कोरिया

coria	कोरिया	कोरिया

corre	कररेया	कोरिया

correa	कररेया	कोरिया

kooria	कोरिया	कोरिया

kooriya	कोरिया	कोरिया

korea	कोरिया	कोरिया

koria	कोरिया	कोरिया

koriya	कोरिया	कोरिया

qoria	कोरिया	कोरिया

qoriya	कोरिया	कोरिया

koreachya	कोरीचाच्या	कोरियाच्या

koriyachya	कोरियाच्या	कोरियाच्या

koreatil	कोरेएातील	कोरियातील

koriyateel	कोरिएातील	कोरियातील

koreane	कोरायाने	कोरियाने

koriyane	कोरियाने	कोरियाने

kovale	कोवळे	कोवळे

kovle	कोवळे	कोवळे

kosh	कोश	कोष

kosabad	कोसबाद	कोसबाड

kosbad	कोसबाड	कोसबाड

kosalato	कोसळतो	कोसळतो

kaumudee	कौमुदी	कौमुदी

kaumudi	कौमुदी	कौमुदी

kram	क्रम	क्रम

kramaat	क्रमात	क्रमात

kramat	क्रमात	क्रमात

kreedangan	क्रेडनंगन	क्रीडांगण

kridangan	क्रिडनंगन	क्रीडांगण

kroorapana	क्रूरपा	क्रूरपणा

kroorpana	कररूर्ाा	क्रूरपणा

cras	क्रॉस	क्रॅश

crash	क्रशस	क्रॅश

crashh	क्रशश	क्रॅश

crush	क्रुस	क्रॅश

kras	क्रॉस	क्रॅश

krash	क्रशस	क्रॅश

krashh	क्रशश	क्रॅश

kryash	क्रिश	क्रॅश

qrash	क्रशस	क्रॅश

crage	क्राज	क्रेग

craig	क्रेग	क्रेग

creeg	क्रेग	क्रेग

creg	क्रेग	क्रेग

kreeg	क्रेग	क्रेग

kreg	क्रेग	क्रेग

qreg	क्रेग	क्रेग

kshatigrast	क्षतिग्रस्त	क्षतिग्रस्त

kshatrap	क्षत्रा	क्षत्रप

kshtrap	क्ष््रा	क्षत्रप

kshatriy	क्षत्रीय	क्षत्रीय

kshatriya	क्षत्रीय	क्षत्रीय

kshamate	क्षमते	क्षमते

kshamatecha	क्षमतेचा	क्षमतेचा

kshamtecha	क्षमतेचा	क्षमतेचा

kshamateche	क्षमतेचे	क्षमतेचे

kshamteche	क्षमतेचे	क्षमतेचे

kshamatene	क्षमतेने	क्षमतेने

kshamatepeksha	क्षमतेपेक्षा	क्षमतेपेक्षा

kshamatemule	क्षमतेमुळे	क्षमतेमुळे

kshamatela	क्षमतेला	क्षमतेला

kshamatevar	क्षमतेवर	क्षमतेवर

kshama	क्षम	क्षमा

khandapeeth	खंदपेठ	खंडपीठ

khandpeeth	खंदपीठ	खंडपीठ

khandpith	खंदपीठ	खंडपीठ

khandojee	खंडोजी	खंडोजी

khandoji	खंडोजी	खंडोजी

khandoba	खंडोबा	खंडोबा

khandobach	खंडोबाच	खंडोबाचं

khandobacha	खंडोबाचा	खंडोबाचं

khandobachm	खंडोबाचं	खंडोबाचं

khandobachya	खंडोबाच्या	खंडोबाच्या

khambeer	खाबीर	खंबीर

khambir	खाबीर	खंबीर

khatpat	खापट	खटपट

khanijanche	खािजांचे	खनिजांचे

khanijanchya	खािजांच्या	खनिजांच्या

khanije	खािजे	खनिजे

kharade	खरडडे	खराडे

khalashani	खााशांनी	खलाशांनी

khalashanni	खााशांनी	खलाशांनी

khalashi	खााशी	खलाशी

khalu	खळू	खलु

khandhyala	खांड्याला	खांद्याला

khandyala	खंंड्याला	खांद्याला

khandhyavaril	खंंड्यावरील	खांद्यावरील

khandyavareel	खांड्यावरील	खांद्यावरील

khandyavaril	खांड्यावरील	खांद्यावरील

khachet	खाचेत	खाचेत

khatyanchee	खतत्यांची	खात्यांची

khatyanchi	खात्यांची	खात्यांची

khatyanche	खतत्यानचे	खात्यांचे

khatyanchya	खतत्यांच्या	खात्यांच्या

khatyakade	खात्याकडे	खात्याकडे

khatyacha	खतत्याचा	खात्याचा

khatyache	खतत्याचे	खात्याचे

khatyat	खात्यात	खात्यात

khatyane	खाट्याने	खात्याने

khatyamadhe	खतत्यामध्ये	खात्यामध्ये

khatyamadhye	खतत्यामध्ये	खात्यामध्ये

khadyapadarthat	खडड्यपदार्था	खाद्यपदार्थात

khanvadi	खांवाी	खानवडी

khanwadi	खांवाी	खानवडी

khanaval	खाणावळ	खानावळ

kharafutee	खररफुती	खारफुटी

kharfuti	खररफुती	खारफुटी

khalavalelee	खळलववलेली	खालावलेली

khalavaleli	खळलववलेली	खालावलेली

khalavalelya	खळलववलेल्या	खालावलेल्या

khalokhal	खळलोखाल	खालोखाल

khalla	खलल्ला	खाल्ला

khallee	खालीली	खाल्ली

khalli	खळलीली	खाल्ली

khasabag	खासबाग	खासबाग

khasbag	खासबाग	खासबाग

khasbhag	खासभाग	खासबाग

khiiladii	खिलाडी	खिलाडी

khiladi	खिलाडी	खिलाडी

qhiladi	खिलाडी	खिलाडी

khilkhile	खिलखिले	खिळखिळे

khile	खिले	खिळे

khuntali	खुंतली	खुंटली

khoode	खुडे	खुडे

khude	खुडे	खुडे

khoop	खुप	खूप

khup	खुप	खूप

khoopach	खूपच	खूपच

khupach	खुपच	खूपच

khoti	खोटी	खोटी

khote	खोटे	खोटे

khot	खोट	खोत

khobanee	खोबणी	खोबणी

khobani	खोबणी	खोबणी

khobne	खोबणे	खोबणी

gangaram	गंगरराम	गंगाराम

gajendra	गजेनद्र	गजेंद्र

gadad	गडद	गडद

gadakhalee	गडाखाली	गडाखाली

gadakhali	गडाखाली	गडाखाली

ganachary	गणाचरर्य	गणाचार्य

ganacharya	गणाचार्य	गणाचार्य

ganika	गणिका	गणिका

gamavat	गमावा	गमावत

gamavalee	गमावली	गमावली

gamavali	गमावली	गमावली

gamavale	गमावले	गमावले

gamavle	गमावले	गमावले

gar	गा	गर

gur	गर	गर

garajeche	गराेचे	गरजेचे

garjeche	गर्ेचे	गरजेचे

garajetoon	गरजेतून	गरजेतून

garajetun	गरजेतून	गरजेतून

garajepeksha	गराेपेक्षा	गरजेपेक्षा

garajepramane	गराेप्रमाणे	गरजेप्रमाणे

garachya	गराच्या	गराच्या

garat	गरात	गरात

gartet	गरतटेत	गर्तेत

gard	गर्ड	गर्द

gardee	गा्डे	गर्दी

gardi	गा्डी	गर्दी

gardeechee	गा्दीची	गर्दीची

gardichi	गादडीची	गर्दीची

gardiche	गादडीचे	गर्दीचे

garditun	गा्डीतून	गर्दीतून

gardimule	गा्डीमुळे	गर्दीमुळे

gadre	गा्रे	गर्दे

garde	गर्डे	गर्दे

garbharapan	गर्भररपण	गर्भारपण

garbharpan	गर्भररपण	गर्भारपण

garbharapanat	गर्भररपणात	गर्भारपणात

garbharpanat	गर्भररपणात	गर्भारपणात

gavai	गवा	गवई

gavalan	गवळण	गवळण

gathave	गाठावे	गाठावे

gabharyat	गाभार्यात	गाभाऱ्यात

galache	गळळाचे	गाळाचे

galat	गालात	गाळात

galane	गालाने	गाळाने

girija	गिरीजा	गिरिजा

gungala	गुणगला	गुंगला

gudgao	गुडगाव	गुडगाव

gudgav	गुडगाव	गुडगाव

gurakhee	गुरखखी	गुराखी

gurakhi	गुराखी	गुराखी

gurunath	गुरुनाथ	गुरुनाथ

gure	गुरे	गुरे

gulchadi	गुलचडी	गुलछडी

gulchhadi	गुलचाी	गुलछडी

gulchhdee	गुलचडी	गुलछडी

gulab	गुलाब	गुलाब

gulabachee	गुलाबाची	गुलाबाची

gulabachi	गुलाबाची	गुलाबाची

gool	गुल	गूळ

gul	गुल	गूळ

gaesvar	गेस्र	गॅसवर

gasvar	गससवर	गॅसवर

gele	गेली	गेले

gelelya	गेलेल्या	गेलेल्या

gat	गाट	गॉट

got	गोट	गॉट

godrej	गोद्ेज	गोदरेज

godee	गोडे	गोदी

godi	गोडी	गोदी

gopala	गोपाळा	गोपाला

goregaon	गोरेगाव	गोरेगाव

goregav	गोरेगाव	गोरेगाव

goleebarat	गोलीबररात	गोळीबारात

golibarat	गोलीबररात	गोळीबारात

goleebaramule	गोलीबररामुळे	गोळीबारामुळे

golibaramule	गोलीबररामुळे	गोळीबारामुळे

govale	गोवाे	गोवले

govarikar	गोवररीकर	गोवारीकर

gowarikar	गोवररीकर	गोवारीकर

gaurav	गौरव	गौरव

gourav	गौरव	गौरव

grahanchee	ग्राांची	ग्रहांची

grahanchi	ग्रहांची	ग्रहांची

grahanche	ग्रहांचे	ग्रहांचे

grahacha	ग्रहाचा	ग्रहाचा

grahachya	ग्रहाच्या	ग्रहाच्या

grahat	ग्रहतत	ग्रहात

grahala	ग्रााला	ग्रहाला

grahavar	ग्रहावर	ग्रहावर

greece	ग्रेच	ग्रीस

greececha	ग्रेकचा	ग्रीसचा

greecechya	ग्रिकच्या	ग्रीसच्या

greecene	ग्रेनने	ग्रीसने

greecemadhye	ग्रिकमध्ये	ग्रीसमध्ये

greecevar	ग्रेकवर	ग्रीसवर

groopache	ग्रुपाे	ग्रूपचे

groupche	ग्रुपचे	ग्रूपचे

groth	ग्रोथ	ग्रोथ

growth	ग्राव	ग्रोथ

gvalher	ग्वाल्हीर	ग्वाल्हेर

gwalior	ग्वालियरय	ग्वाल्हेर

ghataprabha	घटपररभा	घटप्रभा

ghatprabha	घटप्रभा	घटप्रभा

ghatasthapana	घटस्थापना	घटस्थापना

ghatsthapna	घटस्थापना	घटस्थापना

ghadavate	घडवते	घडवते

ghadvate	घडवते	घडवते

gharabandhani	घराांधाी	घरबांधणी

gharabhandhanee	घरांंधाी	घरबांधणी

gharbandhani	घरबंंधणी	घरबांधणी

ghasaralee	घारली	घसरली

ghasarali	घारली	घसरली

ghasaroon	घारून	घसरून

ghasarun	घारून	घसरून

ghagar	घागर	घागर

ghat	घाट	घात

ghatala	घटटला	घातला

ghatla	घटटला	घातला

ghaatlela	घातलेला	घातलेला

ghatalela	घटतलेला	घातलेला

ghatlela	घटतलेला	घातलेला

ghatalelya	घटतलेल्या	घातलेल्या

ghatlelya	घटतलेल्या	घातलेल्या

ghasatat	घासतात	घासतात

ghungaroo	घुंगरू	घुंगरू

ghungaru	घुंगरू	घुंगरू

ghubade	घुबडे	घुबडे

ghruneshwar	घुणेटेशरवर	घृष्णेश्वर

ghrushneshvar	घृषणणेश्वर	घृष्णेश्वर

ghrushneshwar	घुषणणेश्वर	घृष्णेश्वर

ghoshana	घोषाा	घोषणा

chand	छंद	चंद

chanda	चादा	चंद

chandoo	चंदू	चंदू

chandu	चंदू	चंदू

chakkee	चक्की	चक्की

chakki	चक्की	चक्की

chakr	चा्र	चक्र

chakra	चक्र	चक्र

chaqra	चा्रा	चक्र

chakram	चक्रम	चक्रम

chakravartee	चक्राा्ती	चक्रवर्ती

chakravarti	चकररवा्ती	चक्रवर्ती

chakravarutee	चक्रवाूती	चक्रवर्ती

chakravyooh	चक्रा्यू	चक्रव्यूह

chakravyuh	चक्रव्यूह	चक्रव्यूह

chakrvyooh	चा्रव्यो	चक्रव्यूह

chakrakar	चक्रककरर	चक्राकार

chakrache	चक्राचे	चक्राचे

chakrat	चक्रात	चक्रात

chakree	चा्री	चक्री

chakri	चाररी	चक्री

chakreey	चॅ्री	चक्रीय

chakriy	चा्री	चक्रीय

chadh	चढ	चढ

chadhala	चढला	चढला

chadhali	चढली	चढली

chadhale	चढले	चढले

chadhavane	चढवणे	चढवणे

chadhavne	चढवणे	चढवणे

chadhavat	चढवत	चढवत

chadhvat	चढवत	चढवत

chadhavala	चढवला	चढवला

chanchan	चाचं	चणचण

chaturthat	चतुर्थात	चतुर्थात

chamatkar	चमतककार	चमत्कार

chamtkar	चमतककरर	चमत्कार

chamatkarachi	चमतककारचची	चमत्काराची

chamtkarachi	चमतककररचची	चमत्काराची

chamatkarik	चमतककारिक	चमत्कारिक

chamtkarik	चमतककारिक	चमत्कारिक

chalanvadh	चान्ढढ	चलनवाढ

changala	चांगला	चांगला

changla	चांगला	चांगला

changalach	चांगलाच	चांगलाच

changlach	चांगलाच	चांगलाच

chandee	चांदी	चांदी

chandi	चांदी	चांदी

chandeechya	चांदीच्या	चांदीच्या

chandichya	चांदीच्या	चांदीच्या

chandeene	चांदीने	चांदीने

chandine	चांदीने	चांदीने

chandoli	चांदोळी	चांदोली

chambhar	चंंभार	चांभार

chaturmasaat	चटतुर्मससाठ	चातुर्मासात

chaturmasat	चततुर्मससात	चातुर्मासात

charles	चार्लसस	चार्ल्स

charls	चार्लसस	चार्ल्स

charlsa	चार्लसस	चार्ल्स

chaloo	चालू	चालूं

chaloon	चालूनन	चालूं

chalu	चालू	चालूं

cheenchvad	चिंच्ड	चिंचवड

cheenchwad	चिंच्ड	चिंचवड

chiinchwad	चिंच्ड	चिंचवड

chinchavad	चिंचाड	चिंचवड

chinchawad	चिंचाड	चिंचवड

chinchvad	चिंच्ड	चिंचवड

chinchwad	चिंच्ड	चिंचवड

chikat	चिकत	चिकट

chakata	चककटा	चिकटा

chikta	चिक्ा	चिकटा

chikatun	चिकटून	चिकटून

chikatuun	चिकाून	चिकटून

chikati	चिकटटी	चिकाटी

chitrapatasrushti	चित्रपटसृष्टी	चित्रपटसृष्टी

chitrapatsrushti	चित्रपटसृष्टी	चित्रपटसृष्टी

chitrapatasrushtichya	चित्रपटसंष्टीच्या	चित्रपटसृष्टीच्या

chitrapatsrushtichya	चित्रपटसृष्टीच्या	चित्रपटसृष्टीच्या

chitrapatasrushtitil	चित्रपटसंष्टीतील	चित्रपटसृष्टीतील

chitrapatsrushtitil	चित्रपटसृष्टीतील	चित्रपटसृष्टीतील

chitrapatasrushtiwar	चित्रपटसंष्टीवर	चित्रपटसृष्टीवर

chitrapatsrushtivar	चित्रपटसृष्टीवर	चित्रपटसृष्टीवर

chitrapatsrushtiwar	चित्रपटसृष्टीवर	चित्रपटसृष्टीवर

chitrafeet	चित्रफित	चित्रफीत

chitrafit	चित्रफित	चित्रफीत

chitraphit	चित्रफित	चित्रफीत

cheenar	चिनार	चिनार

chinar	चिन्र	चिनार

cheeni	चिनी	चिनी

chini	चिनी	चिनी

cheap	छीअ	चिप

cheep	चीप	चिप

chip	चीप	चिप

cheepalunkar	चिपलूंकर	चिपळूणकर

chipalunkar	चिपळूंकर	चिपळूणकर

chiplunkar	चिपळूंकर	चिपळूणकर

chilkhat	चिलखत	चिलखत

cheelam	चिलंम	चिलीम

chilam	चिलाम	चिलीम

chilim	चिलीम	चिलीम

chile	चाले	चिले

chee	ची	ची

chi	ची	ची

chii	ची	ची

cheese	चीसे	चीज

chij	चीजी	चीज

cheesevastoo	चिसेस्तू	चीजवस्तू

cheesevastu	चिसेस्तू	चीजवस्तू

chijvastoo	चिजवस्तू	चीजवस्तू

chijvastu	चिजवस्तू	चीजवस्तू

chukata	चुकटा	चुकता

chukta	चुक्ा	चुकता

chukali	चुकली	चुकली

chukli	चुकली	चुकली

chukavoon	चुकवून	चुकवून

chukavun	चुकवून	चुकवून

chukvun	चुकवून	चुकवून

chuka	चुका	चुका

championship	चॅम्पिशन्ीप	चॅम्पियनशिप

cheladee	चेळाडी	चेलाडी

cheladi	चेलदडी	चेलाडी

cheshta	चेषटट	चेष्टा

cheshtaa	चेषतटा	चेष्टा

chauki	चौकी	चौकी

chowki	चौकी	चौकी

chaukeevar	चौकीवर	चौकीवर

chaukivar	चौकीवर	चौकीवर

chowkivar	चौकीवर	चौकीवर

chauras	चौरस	चौरस

chouras	चौरस	चौरस

chata	चता	छटा

chhata	छाा	छटा

jagan	जगन	जगणं

jaganm	जगां	जगणं

jagn	जगं	जगणं

jaganyachee	जान्याची	जगण्याची

jaganyachi	जाण्याची	जगण्याची

jagnyachi	जाण्याची	जगण्याची

jaganyaat	जगन्यात	जगण्यात

jaganyat	जाण्यात	जगण्यात

jagnyat	जाण्यात	जगण्यात

jaganyapeksha	जगन्यापेक्षा	जगण्यापेक्षा

jagnyapeksha	जान्यापेक्षा	जगण्यापेक्षा

jaganyashee	जगन्याशी	जगण्याशी

jaganyashi	जगन्याशी	जगण्याशी

jagnyashi	जग््याशी	जगण्याशी

jadangadanivar	जाागदणीवर	जडणघडणीवर

jadanghadanivar	जााघडणीवर	जडणघडणीवर

jadanghadnivar	जााघडनीवर	जडणघडणीवर

janamanasant	जनमनससंंत	जनमानसांत

janmaansaant	जन्ांसंंत	जनमानसांत

janmansant	जन्ांसंंत	जनमानसांत

janamanasavar	जन्णससरवर	जनमानसावर

janmaansaavar	जन्ाससावर	जनमानसावर

janmansavar	जन्ाससावर	जनमानसावर

janaavranchi	जनावरांची	जनावरांची

janavaranchi	जनववरांची	जनावरांची

janawaranchi	जनववरांची	जनावरांची

janaavranchya	जनावरांच्या	जनावरांच्या

janavaranchya	जाववरांच्या	जनावरांच्या

janawaranchya	जाववरांच्या	जनावरांच्या

janaavransaathi	जनावरणंसाठी	जनावरांसाठी

janavaransathi	जनववरणंसाठी	जनावरांसाठी

janawaransathi	जनववरणंसाठी	जनावरांसाठी

janaavrachya	जनावराच्या	जनावराच्या

janavarachya	जनववरचच्या	जनावराच्या

janawarachya	जनववरचच्या	जनावराच्या

janaavras	जनावरास	जनावरास

janavaras	जाववरसस	जनावरास

janawaras	जाववरसस	जनावरास

jabbar	जब्बरर	जब्बार

jamne	जाने	जमणे

jamat	जमा	जमत

jamataat	जमाात	जमतात

jamtaat	जमतात	जमतात

jamtat	जमतात	जमतात

janmtat	जन्ात	जमतात

jamanaalaal	जमााळाल	जमनालाल

jamnalal	जननललाल	जमनालाल

jameenitach	जमिनीतच	जमिनीतच

jamineetach	जमिनीतच	जमिनीतच

jaminitach	जमिनीतच	जमिनीतच

jayraj	जयराज	जयराज

jard	जॉ्द	जर्द

jalvidhyoot	जाविध्योत	जलविद्युत

jalvidhyut	जाविध्यूत	जलविद्युत

jalvidyut	जाविद्यूत	जलविद्युत

jalwidhyoot	जाविध्यूत	जलविद्युत

jalwidyut	जाविद्यूत	जलविद्युत

jalajal	जळजल	जळजळ

jaljal	जळजल	जळजळ

jalatana	जाताना	जळताना

jaltana	जाताना	जळताना

javalakar	जवळकर	जवळकर

javalkar	जवळकर	जवळकर

jawalkar	जवळकर	जवळकर

jast	जा्त	जस्त

jahangeer	जहांगीर	जहांगिर

jahangir	जहांगीर	जहांगिर

jaagarukata	जागरूकता	जागरुकता

jaagrukta	जागरूक्ा	जागरुकता

jagrukta	जागरूक्ा	जागरुकता

jaagaa	जागा	जागा

jaga	जगगा	जागा

jaageech	जागीच	जागीच

jaagich	जागीच	जागीच

jagich	जगगीच	जागीच

jaaniva	जाणिवा	जाणीवा

jaaniwa	जाणिवा	जाणीवा

janiva	जाणिवा	जाणीवा

jaatanya	जातनय	जातंय

jaatay	जात्	जातंय

jatanya	जातणय	जातंय

jatay	जातय	जातंय

jaatichi	जातीची	जातीची

jatichi	जातीची	जातीची

jaatey	जाते	जातेय

jatey	जाते	जातेय

jaadoogar	जादुगर	जादूगर

jaadugar	जादुगर	जादूगर

jadugar	जादुगर	जादूगर

jaaliyanvala	जाळिया्ाला	जालियनवाला

jaaliyanwala	जाळिया्ाला	जालियनवाला

jaliyanvala	जळळिया्ाला	जालियनवाला

jallianwala	जळळिया्ळला	जालियनवाला

jasteecha	जास्तीचा	जास्तीचा

jasticha	जास्तीचा	जास्तीचा

jijaabaainnaa	जिजाबाईंना	जिजाबाईंना

jijabainna	जीजाबाईंना	जिजाबाईंना

jirnoddhar	जीर्णोद्धार	जिर्णोद्धार

jirnodhdaar	जीर्णोध्धार	जिर्णोद्धार

jeevandan	जीवंदान	जीवनदान

jivandaan	जीवंदान	जीवनदान

jiwandaan	जीवनदान	जीवनदान

jaan	जाणण	जुआन

jooan	जोओन	जुआन

juaan	जुओण	जुआन

juan	जुयन	जुआन

zooan	जोओन	जुआन

zuan	जूनन	जुआन

julaimadhye	जुलामध्ये	जुलैमध्ये

julymadhye	जुल्मध्ये	जुलैमध्ये

jethe	जेथे	जेथे

jeefree	जिफररी	जेफ्री

jeefreey	जेफ्रे	जेफ्री

jeephri	जेफररी	जेफ्री

jeffree	जॅफ्री	जेफ्री

jeffrey	जॅफ्रेय	जेफ्री

jeffri	जॅफ्री	जेफ्री

jefree	जिफररी	जेफ्री

jefrei	जेफररे	जेफ्री

jefrey	जेफररे	जेफ्री

jefri	जेफररी	जेफ्री

jefrii	जेफररी	जेफ्री

jephree	जेफररी	जेफ्री

jephrey	जेफररे	जेफ्री

jephri	जेफररी	जेफ्री

jephrii	जेफररी	जेफ्री

zefree	जेफररी	जेफ्री

zefrey	जेफररे	जेफ्री

zephri	जेफररी	जेफ्री

jevadhee	जेवढी	जेवढी

jevadhi	जेवढी	जेवढी

jevdhee	जेवढी	जेवढी

jevdhi	जेवढी	जेवढी

jain	जेन	जैन

jaina	जयन	जैन

jan	जन	जैन

jen	जेन	जैन

jena	जेना	जैन

zain	जेन	जैन

zaina	जयन	जैन

zan	जन	जैन

jainaanche	जैनांचे	जैनांचे

jainanche	जैनांचे	जैनांचे

jac	जॅक	जॉक

jack	जॅक	जॉक

jak	जॅक	जॉक

jaq	जॅक	जॉक

joc	जोक	जॉक

jock	जोक	जॉक

jocq	जोक	जॉक

jok	जोक	जॉक

joq	जोक	जॉक

jyak	ज्क	जॉक

jyok	ज्क	जॉक

jyoq	ज्क	जॉक

zak	झॅक	जॉक

zoc	जोक	जॉक

zock	जॉक	जॉक

zok	जोक	जॉक

zyok	ज्क	जॉक

jo	जो	जो

joe	जोई	जो

joo	जू	जो

jooe	जुई	जो

zoe	जोई	जो

jodgolee	जोडगोळी	जोडगोळी

jodgoli	जोडगोली	जोडगोळी

jodagoleecha	जोडगोळीचा	जोडगोळीचा

jodagolicha	जोडगोळीचा	जोडगोळीचा

jodagolichaa	जोडगोळीचा	जोडगोळीचा

jodgoleecha	जोडगोळीचा	जोडगोळीचा

jodgolicha	जोडगोळीचा	जोडगोळीचा

jodgolichaa	जोडगोळीचा	जोडगोळीचा

jodgolichya	जोडगोळीच्	जोडगोळीचा

jodagoleene	जोडगोलीने	जोडगोळीने

jodagoline	जोडगोलीने	जोडगोळीने

jodgoleene	जोडगोलीने	जोडगोळीने

jodgoline	जोडगोळीने	जोडगोळीने

joparyant	जोपर्यंत	जोपर्यंत

joparyanta	जोपर्यंत	जोपर्यंत

jolee	जोळी	जोली

joli	जोळी	जोली

jolii	जोळी	जोली

jolly	जोली	जोली

joly	जोली	जोली

joolee	जोली	जोली

jooli	जोली	जोली

joolly	जोली	जोली

zolee	झोळी	जोली

zoli	झोळी	जोली

zolly	झोली	जोली

jyada	ज्यादा	ज्यादा

jyadaa	ज्यादा	ज्यादा

jhalakat	झाकट	झळकत

jhalhkat	झाका	झळकत

zalakat	झळकट	झळकत

jhaabooa	झाबू	झाबुआ

jhaabua	झाबू	झाबुआ

jhabooa	झाबू	झाबुआ

jhabua	झाबू	झाबुआ

jhabuaa	झाबू	झाबुआ

zaabooa	जाबू	झाबुआ

zaabua	झाबू	झाबुआ

zabua	झाबू	झाबुआ

zabuaa	झाबू	झाबुआ

jarakhanda	जारखंड	झारखंड

jaraqhanda	जारखंड	झारखंड

jharkhand	झररखंड	झारखंड

jharkhanda	झररखंडा	झारखंड

jharqhand	झररखंड	झारखंड

zarakhanda	झररखंड	झारखंड

zharkhand	झररखंड	झारखंड

zharqhand	झररखंड	झारखंड

jharkhandachya	झररखंडा्या	झारखंडच्या

jharkhandchya	झररखंडच्या	झारखंडच्या

jharkhandchyaa	झररखंडच्या	झारखंडच्या

jhaalyanantar	झाल्यानंतर	झाल्यानंतर

jhalyanantar	झाल्यानंतर	झाल्यानंतर

zaalyanantar	जाल्यानंतर	झाल्यानंतर

zalyaanantar	जाल्यानंतर	झाल्यानंतर

zalyanantar	जाल्यानंतर	झाल्यानंतर

jhalyanantarhi	झाल्यानंतरही	झाल्यानंतरही

zalyanantarahi	झलल्यानंतरही	झाल्यानंतरही

jee	जी	झी

jhi	झी	झी

ji	जी	झी

jii	जी	झी

zee	जी	झी

zi	जी	झी

zii	जी	झी

zero	जेरो	झीरो

jhunj	झुंज	झुंज

zunj	जुंज	झुंज

zunja	जुंजा	झुंज

jhunjee	झुंजी	झुंजी

jhunji	झुंजी	झुंजी

zunji	जुंजी	झुंजी

jhudapaat	झुडपात	झुडपात

jhudapat	झुडपात	झुडपात

jhudpat	झुडपात	झुडपात

zudapaat	झुडपात	झुडपात

zudapat	झुडपात	झुडपात

jhudapi	झुडपी	झुडपी

jhudpi	झुडपी	झुडपी

zudapi	झुडपी	झुडपी

jhuloo	झुलू	झुलू

jhulu	झुलू	झुलू

joolu	जुलू	झुलू

julu	जुलू	झुलू

juuluu	जुलू	झुलू

zaalu	झालू	झुलू

zoolu	झुलू	झुलू

zooluu	जुलू	झुलू

zuloo	जुलू	झुलू

zulu	झुलू	झुलू

zuulu	जुलू	झुलू

zuuluu	जुलू	झुलू

zonal	झोनल	झोनल

zonela	झननिा	झोनल

zopadapatti	झोपदपत्टी	झोपडपट्टी

zopadpatti	झोपदपत्टी	झोपडपट्टी

zopadpattitil	जोपदपत्टीतील	झोपडपट्टीतील

jhoya	झोया	झोया

zoya	जोया	झोया

tandon	ताडो	टंडन

takkal	टक्कल	टक्कल

takkyanni	टक्क्यांनी	टक्क्यांनी

taratara	तााटर	टराटरा

taanksal	टाणकसलल	टांकसाळ

tanksal	टंंकसळल	टांकसाळ

tanksalh	तंंकस्ळ	टांकसाळ

taaknare	टाकणारे	टाकणारे

takanare	टाकणारे	टाकणारे

taknare	टाकणारे	टाकणारे

taakte	ताकते	टाकते

takate	टाकटे	टाकते

takete	टाकटे	टाकते

takte	ताकते	टाकते

taft	तॉफ	टाफ्ट

tafta	ताफतट	टाफ्ट

tapht	ताफ्ट	टाफ्ट

taphta	ताफतट	टाफ्ट

talane	ताळाे	टाळणे

talhne	टाळणे	टाळणे

talhta	ताळता	टाळता

talta	ताळता	टाळता

talali	ताळली	टाळली

talhli	टाळली	टाळली

talhun	ताळून	टाळून

taloon	तळळून	टाळून

talun	तळळून	टाळून

tikato	टीकतो	टिकतो

tikto	टीकतो	टिकतो

takavta	टाकाता	टिकवता

tikavata	टिकाता	टिकवता

tikawata	टिकाता	टिकवता

tikvata	टिकवता	टिकवता

tikavli	टिकाली	टिकवली

tikawali	टीकाली	टिकवली

tikvali	टीकवली	टिकवली

tipoochya	तिपूच्या	टिपूच्या

tipuchya	तीपचच्या	टिपूच्या

tipuchyaa	तीपुच्या	टिपूच्या

tika	तीका	टीका

tiip	टीप	टीप

tiipa	टीपा	टीप

tip	टीप	टीप

tipa	तीपा	टीप

taiiksee	टेक्सी	टॅक्सी

taiiksii	टेक्सी	टॅक्सी

taiixii	टेक्सी	टॅक्सी

taiksee	टेक्सी	टॅक्सी

taikshee	टाक्सी	टॅक्सी

taikshi	टाक्सी	टॅक्सी

taiksi	टाक्सी	टॅक्सी

taiksii	टाक्सी	टॅक्सी

taiqsee	टेक्सी	टॅक्सी

taiqsi	टाक्सी	टॅक्सी

taixi	टेक्सी	टॅक्सी

takshi	टाक्सी	टॅक्सी

taksi	टाक्सी	टॅक्सी

taksii	टकक्सी	टॅक्सी

taqsi	टाक्सी	टॅक्सी

taxi	टाकीसी	टॅक्सी

taxii	ट्क्सी	टॅक्सी

teksee	टेक्सी	टॅक्सी

teksi	टेक्सी	टॅक्सी

texi	टेक्सी	टॅक्सी

tabaleet	तबबलीट	टॅबलेट

tabalet	तबबलेट	टॅबलेट

tableet	तबबलीट	टॅबलेट

tablet	तबबलटट	टॅबलेट

tembhurni	टांभूर्णी	टेंभुर्णी

tenbhurnee	टेंभरर्नी	टेंभुर्णी

tenbhurni	टेंभरर्नी	टेंभुर्णी

tenmurni	टेररूर्नी	टेंभुर्णी

tari	तररी	टेरी

tarrie	तररी	टेरी

tarry	तररी	टेरी

teeri	तररी	टेरी

teerriee	तररी	टेरी

teerry	तररी	टेरी

teri	तररी	टेरी

terie	तररी	टेरी

terii	तररी	टेरी

terrie	तररी	टेरी

terriie	तेरी	टेरी

terry	टररी	टेरी

tery	तररी	टेरी

taresa	तारेस	टेरेसा

teereesa	तारेस	टेरेसा

teeyreesa	तेरेस	टेरेसा

teresa	तेरेस	टेरेसा

teyresa	तेरेसा	टेरेसा

tail	ताल	टेल

tale	तळल	टेल

tel	तेल	टेल

tell	तेल	टेल

topalee	टोपाी	टोपली

topali	टोपाी	टोपली

topli	टोपळी	टोपली

topalya	टोपा्या	टोपल्या

toplya	टोपळ्या	टोपल्या

tope	टोपे	टोपे

topya	टोप्या	टोप्या

tofu	तोफू	टोफू

tofuu	तोफू	टोफू

toofu	तूफू	टोफू

toophu	तूफू	टोफू

tophu	तोफू	टोफू

tophuu	तोफू	टोफू

tola	तोळा	टोला

tole	टोळ	टोले

trackchya	ट्रा््या	ट्रकच्या

trakchya	त्रा््या	ट्रकच्या

truckchya	ट्रक््या	ट्रकच्या

trackavar	ट्रााा	ट्रकवर

trakavar	ट्रकार	ट्रकवर

truckvar	ट्रु््	ट्रकवर

truckwar	ट्रु्ा	ट्रकवर

traks	ट्रॉ्स	ट्रक्स

traqs	ट्रॉ्स	ट्रक्स

trucks	ट्रक्स	ट्रक्स

trucqs	ट्रक्स	ट्रक्स

trackin	ट्रॉक्ंग	ट्रॅकिंग

tracking	ट्रेकिंग	ट्रॅकिंग

tracqing	ट्रेकिंग	ट्रॅकिंग

trakin	ट्रॉकींग	ट्रॅकिंग

traking	ट्रॅकिंग	ट्रॅकिंग

traqing	ट्रॅकिंग	ट्रॅकिंग

traceey	त्रॅसी	ट्रेसी

tracei	ट्रॅ	ट्रेसी

tracey	ट्रॅच	ट्रेसी

traci	ट्रॅसी	ट्रेसी

tracy	ट्रॅची	ट्रेसी

traiisii	ट्रेसी	ट्रेसी

traisi	त्रेसी	ट्रेसी

treci	ट्रेकी	ट्रेसी

trecy	ट्रेकी	ट्रेसी

treecy	ट्रेकी	ट्रेसी

treesi	त्रेसी	ट्रेसी

treesy	त्रेसी	ट्रेसी

tresi	त्रेसी	ट्रेसी

tresii	त्रेसी	ट्रेसी

tresy	त्रेसी	ट्रेसी

tvitar	त्वीटर	ट्विटर

tvittar	त्वीट््	ट्विटर

tvitter	ट्वीट््	ट्विटर

twitar	तीवीटर	ट्विटर

twitara	त्विटर	ट्विटर

twittar	तीवीट््	ट्विटर

twitter	ट्वीट््	ट्विटर

twittervar	त्वीट््र्	ट्विटरवर

tharali	ठरली	ठरली

tharli	ठरली	ठरली

tharavile	ठरविले	ठरविले

tharvile	ठरविले	ठरविले

tharavilelya	ठरविलेल्या	ठरविलेल्या

tharvilelya	ठरविलेल्या	ठरविलेल्या

tharavet	ठरावेत	ठरावेत

thushi	थुशी	ठुशी

thevanyacha	ठेवण्याचा	ठेवण्याचा

thevnyacha	ठेवण्याचा	ठेवण्याचा

thewanyacha	ठेवण्याचा	ठेवण्याचा

thevanyachee	ठेवण्याची	ठेवण्याची

thevnyachi	ठेवण्याची	ठेवण्याची

thewanyachi	ठेवण्याची	ठेवण्याची

thevanyache	ठेवण्याचे	ठेवण्याचे

thevnyache	ठेवण्याचे	ठेवण्याचे

thewanyache	ठेवण्याचे	ठेवण्याचे

thevanyane	ठेवण्याने	ठेवण्याने

thewanyane	ठेवण्याने	ठेवण्याने

thevanyas	ठेवण्यास	ठेवण्यास

thewanyas	ठेवण्यास	ठेवण्यास

thevanyasathee	ठेवण्यासाठी	ठेवण्यासाठी

thevnyasathi	ठेवण्यासाठी	ठेवण्यासाठी

thewanyasathi	ठेवण्यासाठी	ठेवण्यासाठी

dalees	डा्स	डलेस

dales	डा्श	डलेस

dules	डु्श	डलेस

dullees	दु्श	डलेस

dulles	डु्श	डलेस

daakghar	दाकघर	डाकघर

dakaghar	दाकघर	डाकघर

dakghar	दाकघर	डाकघर

dalhimb	दालींब	डाळिंब

dalimb	डालिंब	डाळिंब

dalimba	डालींब	डाळिंब

dalinb	डालींब	डाळिंब

dalhimbacha	दालींबाचा	डाळिंबाचा

dalimbacha	डालींबाचा	डाळिंबाचा

davapech	दावपेच	डावपेच

davpech	दावपेच	डावपेच

dawpech	दावपेच	डावपेच

davapechanchi	दावपेचांची	डावपेचांची

davpechanchi	दावपेचांची	डावपेचांची

depressed	डेप्रेसिसर	डिप्रेस्ड

dipresd	डिप्रेस	डिप्रेस्ड

decembermadhye	डिकंंबरमध्ये	डिसेंबरमध्ये

decemberat	डेकंंबर	डिसेंबरात

deental	डेंटल	डेंटल

dental	डेंटल	डेंटल

dalbee	दालबबी	डॉल्बी

dalbi	दालबबी	डॉल्बी

dalbii	दालबबी	डॉल्बी

dalby	दालबबी	डॉल्बी

dolbee	डोलबबी	डॉल्बी

dolbii	डोल्बी	डॉल्बी

dolby	डोलबबी	डॉल्बी

dongararanga	दोंगररांगा	डोंगररांगा

dongarranga	डोंगररांग	डोंगररांगा

dongararanganni	दोंगररांगांनी	डोंगररांगांनी

dongarranganni	डोंगररांगांनी	डोंगररांगांनी

dohee	दोही	डोही

dohi	दोही	डोही

dram	द्रम	ड्रम

drum	द्रम	ड्रम

drummadhye	द्रु्ध्ये	ड्रममध्ये

dhagaal	ढगाल	ढगाळ

dhagal	ढगळल	ढगाळ

dhagalh	ढगळल	ढगाळ

dhanya	धनन्य	ढाण्या

dhasalhun	ढासाून	ढासळून

dhasalun	ढससाून	ढासळून

dhasloon	धासळून	ढासळून

tantradnyanacha	तंत्रज्ञानाचा	तंत्रज्ञानाचा

tantragyanacha	तंत्रज्ञानाचा	तंत्रज्ञानाचा

tantradnyanachee	तंत्रज्ञानाची	तंत्रज्ञानाची

tantradnyanachi	तंत्रज्ञानाची	तंत्रज्ञानाची

tantragyanachee	तंत्रज्ञानाची	तंत्रज्ञानाची

tantragyanachi	तंत्रज्ञानाची	तंत्रज्ञानाची

tantradnyanache	तंत्रज्ञानाचे	तंत्रज्ञानाचे

tantragyanache	तंत्रज्ञानाचे	तंत्रज्ञानाचे

tantradnyanateel	तंत्रज्ञानातील	तंत्रज्ञानातील

tantradnyanatil	तंत्रज्ञानातील	तंत्रज्ञानातील

tantragyanateel	तंत्रज्ञानातील	तंत्रज्ञानातील

tantragyanatil	तंत्रज्ञानातील	तंत्रज्ञानातील

tantradnyanavar	तंत्रज्ञानावर	तंत्रज्ञानावर

tantragyanavar	तंत्रज्ञानावर	तंत्रज्ञानावर

tantradnyane	तंत्रा्ञाने	तंत्रज्ञाने

tantragyane	तंत्रा्ञाने	तंत्रज्ञाने

tadnyanche	ता्ञांचे	तज्ञांचे

tagyanche	ता्यानचे	तज्ञांचे

tadaka	तडका	तडका

tadka	तडका	तडका

tadakafadakee	तडकफफाीी	तडकाफडकी

tadkafadki	तडकाफाीी	तडकाफडकी

tat	तटात	तत्

tet	तेेत	तत्

tut	तू्त	तत्

tatkaleek	तत्कालिक	तत्कालिक

tatkalik	ता्कालिक	तत्कालिक

tatkaleen	तत्कालीन	तत्कालिन

tatkalin	तत्कालीन	तत्कालिन

tadanantar	तडाातर	तदनंतर

tadnantar	ता्ातर	तदनंतर

tapt	ता्त	तप्त

tapta	तप्त	तप्त

tabakadi	तबकडी	तबकडी

tabkadee	ताकडी	तबकडी

tabkadi	तबकडी	तबकडी

tabalaji	तबलजी	तबलजी

tabalji	तालजी	तबलजी

tablaji	तबलाी	तबलजी

tamanna	तमा्न	तमन्ना

tamannaa	तमा्ना	तमन्ना

taranee	ताणी	तरणी

tarani	तराी	तरणी

taruninsathi	तरुणींसाठी	तरुणींसाठी

tarjanee	तर्जनी	तर्जनी

tarjani	तर्जनी	तर्जनी

tarjni	तरजजनी	तर्जनी

talaghar	ताघर	तळघर

talghar	ताघर	तळघर

talavaroon	तळववरून	तळावरून

talavarun	तळावरून	तळावरून

talawarun	तळावरून	तळावरून

talee	ताी	तळी

tali	ताी	तळी

taloon	तळून	तळून

talun	तळून	तळून

talyacha	ता्याचा	तळ्याचा

talyachya	तल्याच्या	तळ्याच्या

talyavar	ता्यावर	तळ्यावर

tase	ताे	तसे

tasehi	तसेही	तसेही

tandulaja	तांदुळजा	तांदुळजा

tambera	टांबररा	तांबेरा

taag	ताग	ताग

tag	तगग	ताग

taja	तजज	ताजा

tajya	ताज्य	ताज्या

taatkal	तातककाल	तात्काळ

tatkal	तततककाळ	तात्काळ

taneeya	ताणिया	तानिया

tania	ताणिया	तानिया

taniiya	ताणिया	तानिया

taniya	ताणिया	तानिया

taapmaan	तापमान	तापमान

tapaman	तापमान	तापमान

tapman	तापमान	तापमान

taapmanachya	तापमानाच्या	तापमानाच्या

tapamanachya	तापमानाच्या	तापमानाच्या

tapmanachya	तापमानाच्या	तापमानाच्या

taapmanat	तापमानात	तापमानात

tapamanat	तापमानात	तापमानात

tapmanat	तापमानात	तापमानात

taapmanapeksha	तापमानपपेक्षा	तापमानापेक्षा

tapamanapeksha	तापमानपपेक्षा	तापमानापेक्षा

taapmaanamule	तापमानामुळे	तापमानामुळे

tapamanamule	तापमानामुळे	तापमानामुळे

taapamanavar	तापमानावर	तापमानावर

tapamanavar	तापमानावर	तापमानावर

tapmanavar	तपपमानावर	तापमानावर

talibaan	तळलिबान	तालिबान

taliban	तालिबान	तालिबान

talibana	तालिबाना	तालिबान

talyban	ताल्बान	तालिबान

talibanachya	तललिबनंा्या	तालिबानच्या

talibanchya	तललिबांच्या	तालिबानच्या

talibanane	तललिबननाे	तालिबानने

talibanne	तालिबांेे	तालिबानने

taasa	तासा	ताशा

taasha	ताशा	ताशा

taashha	ताश	ताशा

tasa	तसस	ताशा

tasha	तशश	ताशा

tashha	तशश	ताशा

tichyasah	तिच्यासह	तिच्यासह

tichyasaha	तिच्यासहा	तिच्यासह

tithehi	तिथेही	तिथेही

tibarius	तिबरअससस	तिबेरियस

tibariyas	तिबररिया	तिबेरियस

tibeerius	टाबररियस	तिबेरियस

tibeeriyas	तिबिरिया	तिबेरियस

tiberius	टाबररियस	तिबेरियस

tiberiyas	टिबररिया	तिबेरियस

teenda	तींंा	तीनदा

tinada	तीनडा	तीनदा

teelache	तिळचचे	तीळाचे

tilache	तिळाचे	तीळाचे

teeshun	तीशूून	तीसहून

tisahun	तिशाून	तीसहून

tishun	तिशूून	तीसहून

taang	तांग	तुंग

toong	तुंग	तुंग

tung	तंंग	तुंग

toongi	तुंगी	तुंगी

tungee	तंंगी	तुंगी

tungi	तंंगी	तुंगी

tookadicha	तुकडीचा	तुकडीचा

tukadeecha	तुकडीचा	तुकडीचा

tukadicha	तुकडीचा	तुकडीचा

tukadichaa	तुकदीचा	तुकडीचा

tookadiche	तुकडीचे	तुकडीचे

tukadeeche	तुकडीचे	तुकडीचे

tukadiche	तुकडीचे	तुकडीचे

tukdiche	तुकडीचे	तुकडीचे

tookadine	तुकडीने	तुकडीने

tukadeene	तुकडीने	तुकडीने

tukadine	तुकडीने	तुकडीने

tukdine	तुकडीने	तुकडीने

tookadila	तुकडीला	तुकडीला

tukadeela	तुकडीला	तुकडीला

tukadila	तुकडीला	तुकडीला

tukadilaa	तुकदीला	तुकडीला

tukdila	तुकडीला	तुकडीला

tukadoji	तुकडोजी	तुकडोजी

tukdoji	तुकडीजी	तुकडोजी

tujhee	तुझी	तुझी

tujhi	तुझी	तुझी

tuzee	तुझी	तुझी

tuzi	तुझी	तुझी

tumachya	तुमा्या	तुमच्या

tumchya	तुमच्या	तुमच्या

toorichya	तुरीच्या	तुरीच्या

tureechya	तुरीच्या	तुरीच्या

turichya	तुरीच्या	तुरीच्या

turichyaa	तुरीच्या	तुरीच्या

turoongat	तुरुंगात	तुरूंगात

turungaat	तुरुंगात	तुरूंगात

turungat	तुरुंगात	तुरूंगात

toolanatmak	तुलनात्मक	तुलनात्मक

tulanaatmak	तुलनात्मक	तुलनात्मक

tulanatmak	तुलनात्मक	तुलनात्मक

tulnatmak	तुलनात्मक	तुलनात्मक

toopacha	तुपाचा	तूपाचा

tupacha	तुपाचा	तूपाचा

tendulkar	तेंडुळकर	तेंडुलकर

tendulkaranchi	तेंदुळकरांची	तेंडुलकरांची

tendulkaranche	तेंदुळकरांचे	तेंडुलकरांचे

tethale	तेथले	तेथले

tethle	तेथले	तेथले

tethvar	तेथवर	तेथवर

teravya	तेराव्या	तेराव्या

teravyaa	तेराव्या	तेराव्या

terawya	तेराव्या	तेराव्या

telatumbade	तेलतुंबाे	तेलतुंबडे

teltumbade	तेलतुंबाे	तेलतुंबडे

teltumbde	तेलतुंबीे	तेलतुंबडे

tevadham	तेवढं	तेवढं

tevdha	तेवढा	तेवढं

tewdhan	तेवधं	तेवढं

tevadha	तेवढा	तेवढा

tewdha	तेवढा	तेवढा

tyaane	त्याने	त्याने

tyane	त्याने	त्याने

tyanech	त्यानेच	त्यानेच

trayee	त्रेी	त्रयी

trayi	त्राी	त्रयी

tran	ट्रंण	त्राण

trikoot	त्रिकूट	त्रिकूट

trikut	त्रिकूट	त्रिकूट

tribhuj	त्रिभुज	त्रिभुज

tavrit	तावृीत	त्वरित

tvarit	त्वाीत	त्वरित

twarit	त्वाीत	त्वरित

tvashane	त्वशशाने	त्वेषाने

tveshane	त्वेशाने	त्वेषाने

thapave	थापावे	थापावे

danga	डागा	दंगा

dange	डागे	दंगे

dangey	डागे	दंगे

dandak	दादक	दंडक

dandavate	दादवते	दंडवते

dandvate	दंदवते	दंडवते

daramyan	दरा्यान	दरम्यान

darmyan	दरम्यान	दरम्यान

daramyanache	दरा्यानाे	दरम्यानचे

darmyanche	दरम्यांाे	दरम्यानचे

darara	दरारा	दरारा

darja	दर्जा	दर्जा

dajracha	दााररचा	दर्जाचा

darjacha	दर्जाचा	दर्जाचा

darjache	दर्जाचे	दर्जाचा

dajarche	दाागारे	दर्जाचे

darjache	दर्जाचे	दर्जाचे

darjavar	दर्जावर	दर्जावर

darshavate	दर्शवते	दर्शवते

darshavte	दर्शवते	दर्शवते

darshavala	दर्शवाा	दर्शवला

darshavla	दर्शवला	दर्शवला

darshavalee	दर्शवली	दर्शवली

darshavli	दर्शवली	दर्शवली

darshavanaree	दर्शवारीरी	दर्शविणारी

darshaveenari	दर्शविनारी	दर्शविणारी

darshavinari	दर्शविणारी	दर्शविणारी

darshavoo	दर्शवू	दर्शवून

darshavoon	दर्शवून	दर्शवून

darshavu	दरशशवू	दर्शवून

darshavun	दर्शवून	दर्शवून

dalai	दलाई	दलाई

dalal	दललल	दलाल

dalala	डललला	दलाला

dalalana	दलललांना	दलालांना

dalalanna	दलालांना	दलालांना

dalavee	दलवी	दळवी

dalvi	दलवी	दळवी

dasharath	दशर्	दशरथ

dashrath	दश्ा	दशरथ

dashet	दशेत	दशेत

dasara	दसरा	दसरा

dasaraa	दसरा	दसरा

dasra	दसरा	दसरा

daud	दौऊड	दाऊद

dawood	दावदू	दाऊद

dakhavile	दाखविले	दाखविले

dakhvile	दाखविले	दाखविले

dakhavilela	दाखविलेला	दाखविलेला

dakhvilela	दाखविलेला	दाखविलेला

dakhavilelee	दाखविलीली	दाखविलेली

dakhavileli	दाखविलेली	दाखविलेली

dakhvileli	दाखविलेली	दाखविलेली

dakhavilelaya	दाखविलेल्या	दाखविलेल्या

dakhavilelya	दाखविलेल्या	दाखविलेल्या

dakhvilelya	दाखविलेल्या	दाखविलेल्या

dadannee	दादांनी	दादांनी

dadanni	दादांनी	दादांनी

dadasaheb	दादासहहेब	दादासाहेब

dabholkaranche	दाभोळकरांचे	दाभोलकरांचे

damu	दामू	दामू

dareedryachya	दररिद्र्याच्या	दारिद्र्याच्या

daridrachya	दररिद्राचाच्या	दारिद्र्याच्या

daridraychya	दररिद्रायाच्या	दारिद्र्याच्या

daridryachya	दररिद्र्याच्या	दारिद्र्याच्या

daas	दास	दास

das	डास	दास

dasa	दास	दास

dasgupta	दासगुप्त	दासगुप्ता

daah	दाह	दाह

dah	दहह	दाह

deepmal	दिप्ाल	दिपमाळ

dipmaal	दीप्ाल	दिपमाळ

dipmal	दिप््ल	दिपमाळ

dirangaai	दिरंगाई	दिरंगाई

dirangai	दिरंगाई	दिरंगाई

diileep	दिलीप	दिलीप

diiliip	डीलीप	दिलीप

diiliipa	दीलीप	दिलीप

dileep	दिलीप	दिलीप

diliip	दीलीप	दिलीप

dilip	दिलीप	दिलीप

dilipa	दीलिपा	दिलीप

diva	दिवा	दिवा

dubhatee	दुभाी	दुभती

dubhati	दुभाी	दुभती

durustisathi	दुरुस्तीसाठी	दुरुस्तीसाठी

durgeche	दुर्गेचे	दुर्गेचे

durlakshile	दुर्लक्षिले	दुर्लक्षिले

durleshile	दुर्लेिषीले	दुर्लक्षिले

dushman	दुष्मा	दुश्मन

dusar	दुसर	दुसरं

dusaram	दुसरा	दुसरं

dusrn	दुसर्	दुसरं

dusanyach	दुसा्याच	दुसऱ्याच

dusaryach	दुसर्याच	दुसऱ्याच

dusryach	दूसर्याच	दुसऱ्याच

dusanyacha	दुसण्याचा	दुसऱ्याचा

dusaryacha	दूसर्याचा	दुसऱ्याचा

dusryacha	दूसर्याचा	दुसऱ्याचा

dusanyachi	दुसण्याची	दुसऱ्याची

dusaryachee	दुसर्याची	दुसऱ्याची

dusryachi	दूसर्राची	दुसऱ्याची

dusanyane	दुसा्याने	दुसऱ्याने

dusaryane	दूसर्याने	दुसऱ्याने

dusryane	दूसर्याने	दुसऱ्याने

dusanyala	दुसा्याला	दुसऱ्याला

dusaryala	दूसर्याला	दुसऱ्याला

dusryala	दूसर्याला	दुसऱ्याला

dooshne	दुषणे	दूषणे

dushane	दुषाे	दूषणे

dushne	दुषणे	दूषणे

dein	देईन	देईन

deina	डेनना	देईना

deth	देथ	देठ

detha	देथा	देठ

detaana	देताना	देताना

detana	देताना	देताना

devghar	देवघर	देवघर

devgharat	देवघरात	देवघरात

devatance	देवतांचे	देवतांचे

devatanche	देवतांचे	देवतांचे

devtanche	देवतांचे	देवतांचे

devatanna	देवतांना	देवतांना

devtana	देवतानना	देवतांना

devatva	देवत्व	देवत्व

devatwa	देवत्व	देवत्व

devtatav	देवताता	देवत्व

devtatv	देवतातत	देवत्व

devasthancha	देवस्थांचा	देवस्थानचा

devsthancha	देवस्थानचा	देवस्थानचा

devsthanchaa	देवस्थानचा	देवस्थानचा

devasthanchi	देवस्थांची	देवस्थानची

devsthanchee	देवस्थानची	देवस्थानची

devsthanchi	देवस्थांची	देवस्थानची

devasthanchya	देवस्थांच्या	देवस्थानच्या

devsthanchya	देवस्थांच्या	देवस्थानच्या

devasthananchya	देवस्थानांच्या	देवस्थानांच्या

devstananchya	देवस्तानांच्या	देवस्थानांच्या

devsthananchya	देवस्थानचंच्या	देवस्थानांच्या

devasthanachya	देवस्थानाच्या	देवस्थानाच्या

devsthanachya	देवस्थानाच्या	देवस्थानाच्या

devasthan	देवस्थान	देवस्थाने

devasthane	देवस्थाने	देवस्थाने

devsthane	देवस्थाने	देवस्थाने

devicha	देवीचा	देवीचा

devichi	देवीची	देवीची

deviche	देवीचे	देवीचे

devila	देविला	देवीला

devisathi	देविसाठी	देवीसाठी

dehadan	देहदान	देहदान

dehdan	देहदान	देहदान

doghinni	दोघींनी	दोघींनी

donhincha	दोन्हींचा	दोन्हींचा

dhave	द्यावे	द्यावे

dyave	द्यावे	द्यावे

dvarapal	द्वारााल	द्वारपाल

dwarpal	द्वररपाल	द्वारपाल

dvesh	द्वेष	द्वेश

dwesh	द्वेष	द्वेश

dhanik	धनिक	धनिक

dhnik	ध्िक	धनिक

dharan	धरा	धरण

dharananmadhe	धरणांमध्ये	धरणांमध्ये

dharananmadhye	धराांमध्ये	धरणांमध्ये

dharanakade	धरणाकडे	धरणाकडे

dharnakade	धर्ाकडे	धरणाकडे

dharanachee	धरणाची	धरणाची

dharanachi	धरणाची	धरणाची

dharnachi	धरणाची	धरणाची

dharanamule	धरणामुळे	धरणामुळे

dharanala	धरााला	धरणाला

dharnala	धर्ाला	धरणाला

dharanavareel	धरणावरील	धरणावरील

dharanavaril	धरणावरील	धरणावरील

dharnavaril	धरणावरील	धरणावरील

dharanasathee	धरणासाठी	धरणासाठी

dharanasathi	धरणासाठी	धरणासाठी

dharnasathi	धरणासाठी	धरणासाठी

dharalyane	धरल्याने	धरल्याने

dharlyane	धरल्याने	धरल्याने

dhara	धाा	धरा

dharmashastra	धर्मशास्त्र	धर्मशास्त्र

dharmshashtra	धर्मशाश्त्र	धर्मशास्त्र

dharmashastrache	धर्मशास्त्राचे	धर्मशास्त्राचे

dharmshatrache	धर्मशात्त्राचे	धर्मशास्त्राचे

dharmashastrat	धर्मशास्त्रात	धर्मशास्त्रात

dharmshastrat	धर्मशास्त्रात	धर्मशास्त्रात

dharmeeyancha	धर्मीयांचा	धर्मियांचा

dharmiyaancha	धर्मियांचा	धर्मियांचा

dharmiyancha	धर्मियांचा	धर्मियांचा

dharmiyanchi	धर्मियांची	धर्मियांची

dharmiyancha	धर्मियांचाया	धर्मियांच्या

dharmiyanchya	धर्मीयांच्या	धर्मियांच्या

dharmiyansathi	धर्मियांसाठी	धर्मियांसाठी

dharmiyasathi	धर्मीयाससाठी	धर्मियांसाठी

dhunee	धुनी	धुनी

dhuni	धुनी	धुनी

dhumakool	दुमककोळ	धुमाकूळ

dhumakul	धुमककुल	धुमाकूळ

dhoolicha	धुळीचा	धुळीचा

dhulicha	धुळीचा	धुळीचा

dhulikan	धुलिका	धूलिकण

dhrishtadyumna	धृष्टाायादाया	धृष्टद्युम्न

dhrushtaduyamn	धृष्टाूयुमानम	धृष्टद्युम्न

dhrushtadyuamn	धृष्टाायूमानम	धृष्टद्युम्न

dhaivat	धैवत	धैवत

dhondo	धोंडो	धोंडो

dhorana	धोराा	धोरणा

dhorna	धोर्ा	धोरणा

dhoranancha	धोरणांचा	धोरणांचा

dhornancha	धोर्ांचा	धोरणांचा

dhorananchi	धोरणांची	धोरणांची

dhornanchi	धोरणांची	धोरणांची

dhorananchya	धोरणांच्या	धोरणांच्या

dhornanchya	धोर्ांच्या	धोरणांच्या

dhorananna	धोरणांना	धोरणांना

dhorannanna	धोराांनां	धोरणांना

dhornanna	धोरणांना	धोरणांना

dhoranamule	धोरणामुळे	धोरणामुळे

dhornamule	धोरणामुळे	धोरणामुळे

dhoranavar	धोरणावर	धोरणावर

dhornavar	धोरणावर	धोरणावर

dhoranee	धोरणी	धोरणी

dhorani	धोरणी	धोरणी

dhvaneeche	ध्वनीचे	ध्वनीचे

dhvaniche	ध्वनीचे	ध्वनीचे

dhwaniche	ध्वनीचे	ध्वनीचे

dhvaneet	ध्वनीत	ध्वनीत

dhvanit	ध्वनित	ध्वनीत

dhwanit	ध्वनित	ध्वनीत

nandan	नंदा	नंदन

nakos	नकोस	नकोस

nakosa	नकोसा	नकोसा

naksheedaar	नक्षीदार	नक्षीदार

naksheedar	नक्षीदार	नक्षीदार

nakshidar	नक्षीदार	नक्षीदार

nagarche	नारचे	नगरचे

nagarmadhil	नार्ाील	नगरमधील

nagarahun	नाराून	नगरहून

nagarhun	नार्ून	नगरहून

nagare	नारे	नगरे

nagre	नारे	नगरे

najaret	नारेत	नजरेत

najaretoon	नारेतून	नजरेतून

najaretun	नारेतून	नजरेतून

nabh	ना	नभ

nabhee	नाी	नभी

nabhi	नाी	नभी

namaskar	नास्कार	नमस्कार

nayanramy	नाारा्य	नयनरम्य

nayanramya	नाारा्य	नयनरम्य

narake	नाके	नरके

narke	ना्े	नरके

nalkande	नाकांडे	नळकांडे

navanaveen	नानाीन	नवनवीन

navnavin	नवनवीन	नवनवीन

navavee	नवाी	नववी

navavi	नााी	नववी

navakal	नाककाळ	नवाकाळ

navkal	नवककाळ	नवाकाळ

navhatach	ना्हाचचा	नव्हताच

navhtach	नव्हतचच	नव्हताच

navhe	ना्हे	नव्हे

navhech	ना्हेच	नव्हेच

nasat	नसत	नसत

nast	नसत	नसत

nasatm	नसत्	नसतं

nasta	नसता	नसतं

nastn	नस््	नसतं

nastana	नसतानना	नसतांना

nastanna	नसतांना	नसतांना

naseer	नारर	नसीर

nasir	नाीर	नसीर

naangi	नांगी	नांगी

nangee	नांगी	नांगी

nangi	नांगी	नांगी

naanduri	नांदुरी	नांदुरी

nanduree	नांदुरी	नांदुरी

nanduri	नंंदुरी	नांदुरी

naikanchya	नैयकांच्या	नाईकांच्या

naikanchyaa	नैयकांच्या	नाईकांच्या

naikannee	नेईकांनी	नाईकांनी

naikanni	नायकांनी	नाईकांनी

naakyavar	नाक्यावर	नाक्यावर

nakyavar	नाक्यावर	नाक्यावर

nakhoosh	नखखूष	नाखूष

nakhush	नखखूष	नाखूष

naag	नाग	नाग

nag	नाग	नाग

naagli	नागळी	नागली

nagalee	नागळी	नागली

nagli	नागळी	नागली

naagaanchya	नागांच्या	नागांच्या

naganchya	नागांच्या	नागांच्या

naagaanna	नागांना	नागांना

nagana	नागानना	नागांना

naganna	नागांना	नागांना

naagaala	नागाला	नागाला

nagala	नागाला	नागाला

naagojee	नागोजी	नागोजी

nagojee	नागोजी	नागोजी

nagoji	नागोजी	नागोजी

nagya	नगग्य	नाग्या

nachavat	नाचवत	नाचवत

nachvat	नाचवत	नाचवत

naneghat	नानतघात	नाणेघाट

natyancha	नात्यांचा	नात्यांचा

nayab	नययब	नायब

nayar	नायर	नायर

nayara	नायर	नायर

nalyancha	नाल्यांचा	नाल्यांचा

nalyavar	नाल्यावर	नाल्यावर

naheesa	नाहिस	नाहीसा

nahisa	नाहिस	नाहीसा

naheese	नाहिषे	नाहीसे

nahise	नाहिसे	नाहीसे

nigam	निगम	निगम

nigrah	निग्रह	निग्रह

nigraha	निग्रहा	निग्रह

nighato	निघतो	निघतो

nighto	निघतो	निघतो

nighrun	निघून	निघृण

nirghun	निरून	निघृण

nimantran	निमात्रण	निमंत्रण

nimantrit	निमात्रित	निमंत्रित

niyateene	नियतीने	नियतीने

niyatine	नियतीने	नियतीने

niytine	नियतीने	नियतीने

nirsan	निर्न	निरसन

nirnayanmadhye	निर्णयांमध्ये	निर्णयांमध्ये

nirnyanmadhye	निर्ण्ांमध्ये	निर्णयांमध्ये

nirnayache	निर्णयाचे	निर्णयाचे

niranyantar	निरणयांंंतर	निर्णयानंतर

nirnayanantar	निर्णयानंतर	निर्णयानंतर

nirnayane	निर्णयाने	निर्णयाने

nirnayala	निर्णााला	निर्णयाला

nirnayavar	निरणणयावर	निर्णयावर

narnayasathi	नररणणाासाठी	निर्णयासाठी

nirnayasathee	निर्णयासाठी	निर्णयासाठी

nirnayasathi	निर्णयासाठी	निर्णयासाठी

nirdeshak	निर्देशक	निर्देशक

nirdeshakanchee	निर्देशकांची	निर्देशकांची

nirdeshakanchi	निर्देशकांची	निर्देशकांची

nirdeshkanchi	निर्देशकांची	निर्देशकांची

nirvikalp	निर्विकल्प	निर्विकल्प

nirvikalpa	निर्विकल्प	निर्विकल्प

nilya	निल्या	निळ्या

nivadatat	निवडतात	निवडतात

nivadtat	निवडतात	निवडतात

nivdtat	निवडतात	निवडतात

nishanee	निशाणी	निशाणी

nishani	निशाणी	निशाणी

nisseem	निसिसेम	निस्सीम

nissim	निसिसिम	निस्सीम

neelgay	नेलगेय	नीलगाय

nilagay	निलगेय	नीलगाय

nilgaay	निलगाय	नीलगाय

nusatich	नुसतीच	नुसतीच

nustich	नुसतीच	नुसतीच

napoleyanchya	नापोल्याच्या	नेपोलियनच्या

napoliyancha	नापोलियाााया	नेपोलियनच्या

nepoleonchya	नेपोलिनाच्या	नेपोलियनच्या

nemake	नेमके	नेमके

nemke	नेमके	नेमके

nehamee	नेहमी	नेहमी

nehami	नेहमी	नेहमी

nehmi	नेहमी	नेहमी

nehameepeksha	नेहमीपेक्षा	नेहमीपेक्षा

nehmipeksha	नेहमिपेक्षा	नेहमीपेक्षा

naukar	नौकर	नोकर

nokar	नोकर	नोकर

nobal	नोबळल	नोबेल

nobel	नोबलल	नोबेल

nobela	नोबेला	नोबेल

november	नोवाहांबर	नोव्हेंबर

novemberchya	नोवंहंंबरच्या	नोव्हेंबरच्या

novhembarchya	नोव्हेंबरच्या	नोव्हेंबरच्या

novemberla	नोवंहंंबरला	नोव्हेंबरला

novhembarala	नोव्हेंबरला	नोव्हेंबरला

nya	न्या	न्या

nyaa	न्या	न्या

newtoncha	नेयूतोचा	न्यूटनचा

newtonche	न्यूतोचे	न्यूटनचे

newtonchya	नेयूतोच्या	न्यूटनच्या

panditajee	पंडितजी	पंडितजी

panditji	पंडितजी	पंडितजी

pakshaghat	पक्षाघात	पक्षाघात

pakshaghatacha	पक्षागाताचा	पक्षाघाताचा

pagadee	पगडी	पगडी

pagadi	पगडी	पगडी

pagdi	पगडी	पगडी

pachayala	पाायला	पचायला

pachayla	पाायला	पचायला

patakan	पटका	पटकन

patkan	पतका	पटकन

patteree	पत्टररी	पट्टेरी

patteri	पत्टररी	पट्टेरी

padanarya	पडणार्या	पडणाऱ्या

padnarya	पडणार्या	पडणाऱ्या

padat	पदत	पडत

padataloon	पदतळळून	पडताळून

padtalun	पडतळळून	पडताळून

patriket	पत्रिकेत	पत्रिकेत

patriketil	पत्रिकेतील	पत्रिकेतील

pathyakar	पा्यार	पथ्यकर

patyakar	पा्याा	पथ्यकर

padake	पडके	पदके

padabhar	पदभरर	पदभार

padbhar	पदभरर	पदभार

paddhateenchee	पद्धतींची	पद्धतींची

paddhatinchi	पद्धतींची	पद्धतींची

paddhtinchi	पद्धतींची	पद्धतींची

paddhateekade	पद्धतीकडे	पद्धतीकडे

paddhatikade	पद्धतीकडे	पद्धतीकडे

paddhtikade	पद्धतीकडे	पद्धतीकडे

paddhateecha	पद्धतीचा	पद्धतीचा

paddhaticha	पद्धतीचा	पद्धतीचा

paddhticha	पद्धतीचा	पद्धतीचा

paddhateechee	पद्धतीची	पद्धतीची

paddhatichi	पद्धतीची	पद्धतीची

paddhtichi	पद्धतीची	पद्धतीची

paddhateeteel	पद्धतीतील	पद्धतीतील

paddhatitil	पद्धतीतील	पद्धतीतील

paddhtital	पद्धतितलल	पद्धतीतील

paddhateepeksha	पद्धतीपेक्षा	पद्धतीपेक्षा

paddhatipeksha	पद्धतिपेक्षा	पद्धतीपेक्षा

paddhtipeksha	पद्धतिपेक्षा	पद्धतीपेक्षा

paddhateemule	पद्धतीमुळे	पद्धतीमुळे

paddhatimule	पद्धतीमुळे	पद्धतीमुळे

paddhtimule	पद्धतीमुळे	पद्धतीमुळे

paddhatees	पद्धतीस	पद्धतीस

paddhatis	पद्धतीस	पद्धतीस

paddhtis	पद्धतीस	पद्धतीस

paddhatee	पदाधाी	पध्दती

paddhati	पदतयती	पध्दती

paddhateencha	पद्धाींचा	पध्दतींचा

paddhatincha	पद्धतींचा	पध्दतींचा

paddhateechee	पदाधाीची	पध्दतीची

paddhatichi	पदाधतीची	पध्दतीची

paddhateene	पदायतीने	पध्दतीने

paddhatine	पदायतीने	पध्दतीने

paramparancha	परंपरांचा	परंपरांचा

paranparancha	परंपरांचा	परंपरांचा

paramparanchi	परंपरांची	परंपरांची

paranparanchi	परंपरांची	परंपरांची

paramparanchya	परंपरांच्या	परंपरांच्या

paranparanchya	परंपरांच्या	परंपरांच्या

parka	पर्ा	परका

paradeshateel	परदेशातील	परदेशातील

pardeshatil	परदेशातील	परदेशातील

parafekt	परफेक्ट	परफेक्ट

parapheekt	पााीक्ट	परफेक्ट

paraphekt	परफेक्ट	परफेक्ट

parapheqt	पाफेक्ट	परफेक्ट

parfaikt	पर्ाक्ट	परफेक्ट

parfaiqt	पर्ाक्ट	परफेक्ट

parfect	पा्ेक्ट	परफेक्ट

parfeect	पा्ेक्ट	परफेक्ट

parfekt	पर्ेक्ट	परफेक्ट

parphaikt	पा्ाक्त	परफेक्ट

parphect	पर्ेक्ट	परफेक्ट

peerfeekt	पे्ेक्ट	परफेक्ट

perfekt	पेफेक्ट	परफेक्ट

perfeqt	पेफेक्ट	परफेक्ट

perphekt	पर्ेक्ट	परफेक्ट

purfect	पु्ेक्ट	परफेक्ट

purfeect	पु्ेक्ट	परफेक्ट

purphect	पु्ेक्ट	परफेक्ट

paravanageenech	पराानगींचच	परवानगीनेच

paravanginech	पराानगींेच	परवानगीनेच

parvanginech	पर्ानगींेच	परवानगीनेच

paranajape	परणजजपे	परांजपे

paranjape	परंंजपे	परांजपे

parabav	पराबा	पराभव

parabhav	परभभा	पराभव

parabhaw	परभभा	पराभव

parabhavacha	परभभााचा	पराभवाचा

parabhawacha	परभभााचा	पराभवाचा

parabhavachya	परभभााच्या	पराभवाच्या

parabhawachya	परभभााच्या	पराभवाच्या

parabhavanantar	परभभाानंतर	पराभवानंतर

parabhavanatar	परभभाानातर	पराभवानंतर

parabhavane	परभभााने	पराभवाने

parabhawane	परभभााने	पराभवाने

parikashan	परिक्षण	परिक्षण

parikshan	परीक्षण	परिक्षण

paricched	पर्क्चे	परिच्छेद

parichcheda	परिच्छेदा	परिच्छेद

parichchhed	परिच्छेद	परिच्छेद

parichhed	परिच्छे	परिच्छेद

parinatee	परिणाी	परिणती

parinati	परिणाी	परिणती

parivarasah	परिवाराहह	परिवारासह

pariwarasah	परिवाराहह	परिवारासह

paroksh	परोक्ष	परोक्ष

paroksha	परोक्षा	परोक्ष

parn	पर्न	पर्ण

parna	पर्ना	पर्ण

paryavekshak	पर्यवेक्षा	पर्यवेक्षक

parv	पा्व	पर्व

parva	पर्व	पर्व

parva	पर्व	पर्वा

parvache	पर्वाचे	पर्वाचे

parvachya	पर्वाच्	पर्वाचे

parvaat	पर्वात	पर्वात

parvala	पर्वलला	पर्वात

parvat	पर्वतत	पर्वात

parvala	पर्वलला	पर्वाला

parsanal	पर्शनल	पर्सनल

parsonal	पर्शनल	पर्सनल

pearsanal	पर्शनल	पर्सनल

pearsonal	पर्सनल	पर्सनल

persanal	पर्शनल	पर्सनल

personal	पर्शनल	पर्सनल

pursnal	पू्षना	पर्सनल

palang	पााग	पलंग

pavar	पारर	पवार

pawar	पारर	पवार

pawarancha	पाररांचा	पवारांचा

pawaranchaa	पाररांचा	पवारांचा

pawaranchya	पाररांच्या	पवारांच्या

pawaranchyaa	पाररांच्या	पवारांच्या

pawaranna	पाररांना	पवारांना

pawarannaa	पाररांना	पवारांना

pawarannee	पाररांनी	पवारांनी

pawaranni	पाररांनी	पवारांनी

pasarate	पसरते	पसरते

pasarte	पसरते	पसरते

pahalvaan	पहा्ान	पहलवान

pahalvan	पहा्ान	पहलवान

pahalwan	पहा्ान	पहलवान

pahaanyas	पााण्यास	पहाण्यास

pahanyas	पााण्यास	पहाण्यास

pahaanyasathi	पााण्यासाठी	पहाण्यासाठी

pahanyasathee	पााण्यासाठी	पहाण्यासाठी

pahanyasathi	पााण्यासाठी	पहाण्यासाठी

paaus	पाऊऊ	पाउस

paus	पाऊस	पाउस

pause	पौऊश	पाउस

pakadi	पककडी	पाकळी

pakali	पककळी	पाकळी

pakdi	पककडी	पाकळी

paklee	पककळी	पाकळी

paakeeshtan	पॅकीश्थान	पाकिस्तान

paakeestan	पॅकिस्टान	पाकिस्तान

paakeshtan	पॅकेश्थान	पाकिस्तान

paakestan	पॅकसस्टान	पाकिस्तान

paakiistan	पॅकिस्टान	पाकिस्तान

paakishtan	पॅकिष्तान	पाकिस्तान

paakistan	पॅकिस्तान	पाकिस्तान

paaqeestan	पॅकिस्टान	पाकिस्तान

paaqestan	पॅकसस्टान	पाकिस्तान

paaqistan	पॅकिस्टान	पाकिस्तान

pakishtana	पॅकिश्ताना	पाकिस्तान

pakishthan	पॅकिश्थान	पाकिस्तान

pakistan	पॅकिस्टान	पाकिस्तान

pakistana	पॅकिस्टान	पाकिस्तान

pakisthan	पॅकिस्थान	पाकिस्तान

paqistana	पॅकिस्टान	पाकिस्तान

paqisthan	पॅकिस्थान	पाकिस्तान

pakistanacha	पककिस्तानचा	पाकिस्तानचा

pakistanchya	पॅकिस्तांच्	पाकिस्तानचा

pakisthancha	पककिस्थांचा	पाकिस्तानचा

pakistanmadheel	पॅकिस्तांमधील	पाकिस्तानमधील

pakistanmadhil	पॅकिस्तांाधील	पाकिस्तानमधील

pakisthanmadhil	पॅकिस्तांाधील	पाकिस्तानमधील

pakistanmadhye	पाकिस्तांमध्ये	पाकिस्तानमध्ये

pakisthanmaddhe	पककिस्तांमध्ये	पाकिस्तानमध्ये

pakistanla	पककिस्तांला	पाकिस्तानला

pakisthanla	पककिस्थानला	पाकिस्तानला

paakistanvar	पाकिस्तां्र	पाकिस्तानवर

pakistanvar	पाकिस्तां्र	पाकिस्तानवर

pakisthanvar	पककिस्थां्र	पाकिस्तानवर

pakisthanwar	पककिस्थान्र	पाकिस्तानवर

pakistanat	पाकिस्तानात	पाकिस्तानात

pakisthanat	पाकिस्थानात	पाकिस्तानात

pakistanateel	पॅकिस्तानातील	पाकिस्तानातील

pakistanatil	पाकिस्तानातील	पाकिस्तानातील

pakisthanatil	पककिस्तानातील	पाकिस्तानातील

pakeestani	पॅकिस्टांी	पाकिस्तानी

pakeestanii	पॅकिस्टांी	पाकिस्तानी

pakeystani	पॅकिस्टानी	पाकिस्तानी

pakeystanii	पॅकेस्टांी	पाकिस्तानी

pakiistani	पॅकिस्टानी	पाकिस्तानी

pakiistanii	पॅकिस्टानी	पाकिस्तानी

pakistanee	पॅकिस्तानी	पाकिस्तानी

pakistani	पॅकिस्तानी	पाकिस्तानी

pakisthani	पककिस्तानी	पाकिस्तानी

paqeestani	पॅकिस्टानी	पाकिस्तानी

paqeystani	पॅकिस्टानी	पाकिस्तानी

paqistani	पॅकिस्टानी	पाकिस्तानी

paakhara	पाखरा	पाखरा

pakhra	पाखरा	पाखरा

pajhar	पाजा	पाझर

pathbadavar	पाठबदावर	पाठबळावर

pathbalavar	पाठबलावर	पाठबळावर

pathbalawar	पाठबलावर	पाठबळावर

pathbhed	पाठभेद	पाठभेद

pathavne	पाठवणे	पाठवणे

pathvane	पाठवणे	पाठवणे

pathwane	पाठवणे	पाठवणे

pathavnyas	पाठवण्यास	पाठवण्यास

pathvanyas	पाठवण्यास	पाठवण्यास

pathavta	पाठवता	पाठवता

pathawata	पाठवता	पाठवता

pathvata	पाठवता	पाठवता

pathavali	पाठवली	पाठवली

pathvali	पाठवली	पाठवली

pathvlee	पाठवली	पाठवली

pathavale	पाठवले	पाठवले

pathvale	पाठवले	पाठवले

pathava	पाठवा	पाठवा

pathva	पाठवा	पाठवा

pathavi	पाठाी	पाठवी

pathvee	पाठवी	पाठवी

pathvi	पाठवी	पाठवी

pathavit	पाठवीत	पाठवीत

pathveet	पाठवीत	पाठवीत

pathvit	पाठवीत	पाठवीत

pathavu	पाठवू	पाठवू

pathcu	पठठूू	पाठवू

pathvoo	पाठवू	पाठवू

pathvu	पाठवू	पाठवू

pathavun	पाठवून	पाठवून

pathvoon	पाठवून	पाठवून

pathvun	पाठवून	पाठवून

padnyachaya	पडडण्याचाया	पाडण्याच्या

padnyachya	पाडण्याच्या	पाडण्याच्या

padnyaat	पाडण्यात	पाडण्यात

padnyat	पाडण्यात	पाडण्यात

paadvi	पादवी	पाडवी

padvi	पददवी	पाडवी

padwi	पददवी	पाडवी

paantavane	पाणतावाे	पानतावणे

pantavane	पंणतावाे	पानतावणे

papkshalan	पपपक्षालन	पापक्षालन

payathya	पायथ्य	पायथ्या

paythya	पायथ्य	पायथ्या

payathayache	पायथायाचे	पायथ्याचे

payathyache	पायथ्याचे	पायथ्याचे

payathyachya	पायथ्याच्या	पायथ्याच्या

paythyachya	पायथ्याच्या	पायथ्याच्या

payathyapasoon	पायथ्यापासून	पायथ्यापासून

payathyapasun	पायथ्यापासून	पायथ्यापासून

payathyala	पायथ्याला	पायथ्याला

payathyashee	पायथ्याशी	पायथ्याशी

payathyashi	पायथ्याशी	पायथ्याशी

payal	पाया	पायल

paramparik	पारंपररिक	पारंपारिक

paark	पार्क	पार्क

paarq	पार्क	पार्क

park	परर्क	पार्क

parq	परर्क	पार्क

parkacha	परर्काा	पार्कचा

parkcha	परर्कचा	पार्कचा

parkche	पररखकचे	पार्कचे

paarkar	पार्कर	पार्कर

paarker	पार्कर	पार्कर

paarqar	पार्कर	पार्कर

paarqer	पार्कर	पार्कर

parkar	परर्कर	पार्कर

parkara	परर्कर	पार्कर

parker	परर्कर	पार्कर

parqara	परर्कर	पार्कर

parqer	परर्कर	पार्कर

parkvar	परर्क्ा	पार्कवर

palo	पालो	पालो

paloo	पाळू	पालो

paalee	पाली	पाळी

pali	पाली	पाळी

paleeche	पललीचे	पाळीचे

paliche	पालीचे	पाळीचे

paleet	पालीत	पाळीत

palit	पललीत	पाळीत

pavala	पावला	पावला

pavla	पावला	पावला

pawla	पावळा	पावला

pavalavar	पावलावर	पावलावर

pavlavar	पावलावर	पावलावर

pawlawar	पावलावर	पावलावर

pasa	पासा	पाशा

pasha	पासा	पाशा

pashha	पासा	पाशा

pahije	पहहिजे	पाहिजे

pingat	पंंगत	पिंगट

pindadan	पिंडगान	पिंडदान

pinddan	पिंड्	पिंडदान

pital	पातळ	पितळ

pitalee	पितळी	पितळी

pitali	पितळी	पितळी

pitamah	पीतममह	पितामह

pujalee	पुजली	पुजली

pujali	पुजली	पुजली

pujale	पुजले	पुजले

pudhachee	पुढीी	पुढची

punatamba	पुनतांबा	पुणतांबा

puntamba	पुंतांबा	पुणतांबा

punarbharan	पुनर्भरण	पुनर्भरण

puranbharan	पुररभभरण	पुनर्भरण

puravato	पुरवतो	पुरवतो

purichya	पूरीच्या	पुरीच्या

puruchya	पुरुच्या	पुरीच्या

purushatva	पुरुषत्व	पुरुषत्व

purushottam	पुरुषोट्तम	पुरुषोत्तम

pureshee	पुरेशी	पुरेशी

pureshi	पुरेशी	पुरेशी

pooshti	पोष्टी	पुष्टी

pushtee	पुष्टी	पुष्टी

pushti	पुष्टी	पुष्टी

purtisathi	पूर्तीसाठी	पूर्तीसाठी

purvajanche	पुर्वाानचे	पूर्वजांचे

purvjanche	पुर्वजानचे	पूर्वजांचे

purvaniyojit	पुर्वाियोतित्	पूर्वनियोजित

purvniyojit	पूर्विियोजित	पूर्वनियोजित

poorvsthitit	पूर्वस्थितीत	पूर्वस्थितीत

purvasthitit	पुर्वस्थितीत	पूर्वस्थितीत

purvsthitit	पुर्वस्थितीत	पूर्वस्थितीत

poorva	पूर्व	पूर्वा

purva	पुर्व	पूर्वा

purvekade	पुर्वेकडे	पूर्वेकडे

prithvi	पृथ्वी	पृथ्वी

pruthvi	पृथ्वी	पृथ्वी

prithvicha	पृथ्वीचा	पृथ्वीचा

pruthvicha	पृथ्वीचा	पृथ्वीचा

prithviche	पृथ्वीचे	पृथ्वीचे

pruthviche	पृथ्वीचे	पृथ्वीचे

prithvichya	पृथ्वीच्या	पृथ्वीच्या

pruthvichya	पृथ्वीच्या	पृथ्वीच्या

prithvipasun	पृथ्वीपासून	पृथ्वीपासून

pruthvipasoon	पृथ्वीपासून	पृथ्वीपासून

pruthvipasun	पृथ्वीपासून	पृथ्वीपासून

prithvila	पृथ्वीला	पृथ्वीला

pruthvila	पृथ्वीला	पृथ्वीला

prithvivar	पृथ्वीवर	पृथ्वीवर

pruthvivar	पृथ्वीवर	पृथ्वीवर

prithvivaril	पृथ्वीवरील	पृथ्वीवरील

pruthvivaril	पृथ्वीवरील	पृथ्वीवरील

packeet	पककेट	पॅकेट

packet	पकक्ट	पॅकेट

pacqet	पॅक्ट	पॅकेट

pakeet	पाकेट	पॅकेट

paket	पाकेट	पॅकेट

paqet	पाकेट	पॅकेट

pyackeet	प्किट	पॅकेट

pyacket	प्किट	पॅकेट

pyacqet	पॅक्ट	पॅकेट

pyakeet	प्कीट	पॅकेट

pyaket	पॅकेट	पॅकेट

pyaqet	पॅकेट	पॅकेट

parismadheel	पररिसमधील	पॅरिसमधील

parismadhil	पररिस्धील	पॅरिसमधील

parisla	पररिस्ा	पॅरिसला

parisvar	पररिस्र	पॅरिसवर

pariswar	पररिस्ा	पॅरिसवर

palestain	पालिस्टनईन	पॅलेस्टाईन

palestine	पालेस्टीनन	पॅलेस्टाईन

paintar	पांटर	पेंटर

painteer	पिंटर	पेंटर

painter	पांटर	पेंटर

peentar	पिंटर	पेंटर

peenteer	पिंटर	पेंटर

pentar	पेंटर	पेंटर

penter	पिंटर	पेंटर

pendharkar	पेंढररकर	पेंढारकर

page	पाग	पेज

peg	पिग	पेज

pej	पीज	पेज

paperche	पाररचे	पेपरचे

papermadhe	पाररमध्ये	पेपरमध्ये

papermadhye	पाररमध्ये	पेपरमध्ये

papars	पाफर्स	पेपर्स

papeers	पाफर्स	पेपर्स

papers	पाफर्स	पेपर्स

peepars	पेपर्स	पेपर्स

pepars	पेफर्स	पेपर्स

pari	पररी	पेरी

parry	पररी	पेरी

peeri	पेरी	पेरी

peerry	पररी	पेरी

peri	पररी	पेरी

perii	पेरी	पेरी

perri	पररी	पेरी

perry	पररी	पेरी

pery	पररी	पेरी

peshavepad	पेशाेपळ	पेशवेपद

peshvepad	पेशवेपळ	पेशवेपद

paithanee	पैठाी	पैठणी

paithani	पैठाी	पैठणी

paithni	पैठणी	पैठणी

patar	पाटर	पॉटर

patter	पटटर	पॉटर

petar	पेटर	पॉटर

potar	पोटर	पॉटर

poter	पोटर	पॉटर

pottar	पोटर	पॉटर

potter	पॉटर	पॉटर

pot	पोट	पोट

potchya	पोचच्या	पोटच्या

potakade	पोटाकडे	पोटाकडे

potache	पोटाचे	पोटाचे

potat	पोटात	पोटात

potateel	पोतातील	पोटातील

potatil	पोतातील	पोटातील

potamaddhe	पोटममध्ये	पोटामध्ये

potamadhe	पोतामध्ये	पोटामध्ये

potamadhye	पोतामध्ये	पोटामध्ये

potala	पोटाला	पोटाला

potashee	पोताशी	पोटाशी

potashi	पोताशी	पोटाशी

potee	पोटी	पोती

poti	पोटी	पोती

pofalee	पोफली	पोफळी

pofali	पोफली	पोफळी

pofdi	पोफळी	पोफळी

pophadi	पोफाी	पोफळी

pophalee	पोफली	पोफळी

pophali	पोफली	पोफळी

portugesejancha	पोर्तुगेतांचा	पोर्तुगीजांचा

portugijancha	पोर्तुगीजांचा	पोर्तुगीजांचा

potuguesancha	पोटगगुंांांचा	पोर्तुगीजांचा

portugesejani	पोर्टुगेताननी	पोर्तुगीजांनी

portugijanni	पोर्तुगीजांनी	पोर्तुगीजांनी

portuguesanni	पोर्टुगुंांनी	पोर्तुगीजांनी

poliocha	पोलिओचा	पोलिओचा

poloocha	पोलूचचा	पोलिओचा

poleesannee	पोलिसांनी	पोलीसांनी

policanni	पोलिकांनी	पोलीसांनी

polisanni	पोलिसांनी	पोलीसांनी

poleechee	पोलीची	पोळीची

poleechi	पोलीची	पोळीची

polichi	पोलीची	पोळीची

poshanasathee	पोषणासाठी	पोषणासाठी

poshanasathi	पोषणासाठी	पोषणासाठी

poshnasathi	पोषणासाठी	पोषणासाठी

poostal	पोस्टल	पोस्टल

poostala	पोस्टाा	पोस्टल

poshtal	पोष्टल	पोस्टल

poshtala	पोश्टा	पोस्टल

postal	पोस्टल	पोस्टल

postala	पोस्टाा	पोस्टल

paugandavastheteel	पौगंडवसस्थेतील	पौगंडावस्थेतील

paugandavasthetil	पौगंडवसस्थेतील	पौगंडावस्थेतील

pougandavasthetil	पौगंडवसस्थेतील	पौगंडावस्थेतील

prakat	प्रकट	प्रकट

prakatapane	प्रकटपणे	प्रकटपणे

prakatpane	प्रकटपणे	प्रकटपणे

prakatala	प्रकटला	प्रकटला

prakar	प्रकार	प्रकार

prakarancha	प्रकररांचा	प्रकारांचा

prakaranchee	प्रकररांची	प्रकारांची

prakaranchi	प्रकररांची	प्रकारांची

prakaranche	प्रकररांचे	प्रकारांचे

prakaranna	प्रकररांना	प्रकारांना

prakaranpaikee	प्रकारांपैकी	प्रकारांपैकी

prakaranpaiki	प्रकारणंपैकी	प्रकारांपैकी

prakaransathee	प्रकारांसाठी	प्रकारांसाठी

prakaransathi	प्रकररांसाठी	प्रकारांसाठी

prakarat	प्रकारतत	प्रकारात

prakarateel	प्रकारातील	प्रकारातील

prakaratil	प्रकारातील	प्रकारातील

prakaratoon	प्रकारातून	प्रकारातून

prakaratun	प्रकारातून	प्रकारातून

prakarane	प्रकररणने	प्रकाराने

prakaramule	प्रकारामुळे	प्रकारामुळे

prakaravaroon	प्रकररावरून	प्रकारावरून

prakaravarun	प्रकररावरून	प्रकारावरून

prakaras	प्रकारास	प्रकारास

prakarasathee	प्रकारासाठी	प्रकारासाठी

prakarasathi	प्रकररासाठी	प्रकारासाठी

prakriyecha	प्रक्रियाचा	प्रक्रियेचा

prakriyechya	प्रकृरियाच्या	प्रक्रियेच्या

prakriyet	प्रक्रियेत	प्रक्रियेत

prakriyene	प्रक्रियेने	प्रक्रियेने

prakriyepasoon	प्रक्रियेपासून	प्रक्रियेपासून

prakriyepasun	प्रक्रियेपासून	प्रक्रियेपासून

prakriyemule	प्रक्रियेमुळे	प्रक्रियेमुळे

prakriyela	प्रक्रियेला	प्रक्रियेला

prakriyeshee	प्रक्रिशेशी	प्रक्रियेशी

prakriyeshi	प्रक्रिशेशी	प्रक्रियेशी

prakriyes	प्रक्रियास	प्रक्रियेस

prajaanan	प्रजानन	प्रजाजन

prajajan	प्रजाजन	प्रजाजन

prajanan	प्रजननन	प्रजाजन

prajapatee	प्रजापती	प्रजापती

prajapati	प्रजापती	प्रजापती

pranay	प्रा्	प्रणय

pranayachya	प्राााच्या	प्रणयाच्या

pranete	प्राेते	प्रणेते

pratapgad	प्रतापगड	प्रतापगड

pratapagadavareel	प्रतापगडावरील	प्रतापगडावरील

pratapgadavareel	प्रतापगडावरील	प्रतापगडावरील

pratapgadavaril	प्रतापगाावरील	प्रतापगडावरील

prateenidhitv	प्रतिनिधित्व	प्रतिनिधीत्व

pratinidheetv	प्रतिनिधित्व	प्रतिनिधीत्व

pratinidhitv	प्रतिनिधित्व	प्रतिनिधीत्व

pratinidhitva	प्रतिनिधित्व	प्रतिनिधीत्व

pratipal	प्रतिपाल	प्रतिपाळ

pratipla	प्रतिपलला	प्रतिपाळ

pratishthan	प्रतिष्ठान	प्रतिष्ठान

pratisthan	प्रतिष्ठान	प्रतिष्ठान

pratishthanacha	प्रतिष्ठानाा	प्रतिष्ठानचा

pratishthancha	प्रतिष्ठांचा	प्रतिष्ठानचा

pratisthancha	प्रतिस्ठांाा	प्रतिष्ठानचा

pratishthanachee	प्रतिष्ठानाी	प्रतिष्ठानची

pratishthanchi	प्रतिष्ठांाी	प्रतिष्ठानची

pratisthanchi	प्रतिस्ठांाी	प्रतिष्ठानची

pratishthanache	प्रतिष्ठानाे	प्रतिष्ठानचे

pratishthanche	प्रतिष्ठानचे	प्रतिष्ठानचे

pratishthanachya	प्रतिष्ठाना्या	प्रतिष्ठानच्या

pratishthanchya	प्रतिष्ठांच्या	प्रतिष्ठानच्या

pratishthanane	प्रतिष्ठानेे	प्रतिष्ठानने

prathecha	प्रथेचा	प्रथेचा

pradeshaatach	प्रदेशातच	प्रदेशातच

pradeshatach	प्रदेशातच	प्रदेशातच

pradeshatch	प्रदेशातच	प्रदेशातच

prapanch	प्रााच	प्रपंच

prapancha	प्रााचा	प्रपंच

prapanchat	प्रााचात	प्रपंचात

prabodhankar	प्रबोधाकरर	प्रबोधनकार

pramanpatr	प्रमाणपत्र	प्रमाणपत्र

pramanpatra	प्रमाणपत्र	प्रमाणपत्र

pramanbhut	प्रमाणभूत	प्रमाणभूत

pramanech	प्रमाणेच	प्रमाणेच

pramannech	प्रमाण्च	प्रमाणेच

pramookh	प्रमुख	प्रमूख

pramukh	प्रमुख	प्रमूख

prayog	प्रयोग	प्रयोग

prayogshaleteel	प्रयोगशाळीतील	प्रयोगशाळेतील

prayogshaletil	प्रयोगशालेतील	प्रयोगशाळेतील

prayogancha	प्रयोगांचा	प्रयोगांचा

prayoganchee	प्रयोगांची	प्रयोगांची

prayoganchi	प्रयोगांची	प्रयोगांची

prayogant	प्रयोगांत	प्रयोगांत

prayoganmadhye	प्राोगांमध्ये	प्रयोगांमध्ये

prayogaantee	प्रयोगांंती	प्रयोगाअंती

prayogaanti	प्रयोगांंती	प्रयोगाअंती

prayogache	प्राोगाचे	प्रयोगाचे

prayogachey	प्राोगाचे	प्रयोगाचे

prayogachya	प्रयोगाच्या	प्रयोगाच्या

prayogateel	प्रयोगातील	प्रयोगातील

prayogatil	प्रयोगातील	प्रयोगातील

prayoganantar	प्रयोगणनंतर	प्रयोगानंतर

prayogananter	प्रयोगणनंतर	प्रयोगानंतर

prayogaala	प्रयोगाला	प्रयोगाला

prayogala	प्रयोगाला	प्रयोगाला

prayogasaathi	प्रयोगाठाठी	प्रयोगासाठी

prayogasadhee	प्रयोगादाधी	प्रयोगासाठी

prayogasathi	प्रयोगाठाठी	प्रयोगासाठी

pravan	प्रवण	प्रवण

pravaranagar	प्रवरानगर	प्रवरानगर

pravranagar	प्रवरानगर	प्रवरानगर

pravasvarnan	प्रवास्र्णन	प्रवासवर्णन

pravasvarnane	प्रवास्र्णाे	प्रवासवर्णने

praveshahee	प्रवेशाी	प्रवेशही

praveshahi	प्रवेशाी	प्रवेशही

praveshacha	प्रवेशाचा	प्रवेशाचा

praveshat	प्रवेशात	प्रवेशात

praveshasathee	प्रवेशासाठी	प्रवेशासाठी

praveshasathi	प्रवेशासाठी	प्रवेशासाठी

prashasan	प्रशासन	प्रशासन

prashashan	प्रशाश्	प्रशासन

prashasanat	प्रशासनात	प्रशासनात

prashasanane	प्रशासनाने	प्रशासनाने

prashasanala	प्रशासनाला	प्रशासनाला

prashasnala	प्रशासनाला	प्रशासनाला

prashasanavar	प्रशासनावर	प्रशासनावर

prashasnavar	प्रशासनावर	प्रशासनावर

prashasanik	प्रशासािक	प्रशासनिक

prasadacha	प्रसादाचा	प्रसादाचा

prasadachee	प्रसादाची	प्रसादाची

prasadachi	प्रसादाची	प्रसादाची

prasootee	प्रसूती	प्रसूति

prasuti	प्रसूती	प्रसूति

praant	प्रांत	प्रांत

prant	प्रांत	प्रांत

prantanchee	प्रांतांची	प्रांतांची

prantanchi	प्रांतांची	प्रांतांची

prantaant	प्रांतांत	प्रांतांत

prantant	प्रांतांत	प्रांतांत

praantacha	प्रांताचा	प्रांताचा

prantacha	प्रांताचा	प्रांताचा

prantache	प्रांताचे	प्रांताचे

prantachey	प्रंंताचे	प्रांताचे

prantateel	प्रांतातील	प्रांतातील

prantatil	प्रांतातील	प्रांतातील

prantatoon	प्रांतातून	प्रांतातून

prantatun	प्रांतातून	प्रांतातून

praantamadhye	प्रांतामध्ये	प्रांतामध्ये

prantamadhye	प्रांतममध्ये	प्रांतामध्ये

prantaala	प्रांताला	प्रांताला

prantala	प्रांतलला	प्रांताला

prantavar	प्रांतावर	प्रांतावर

prantawar	प्रांतावर	प्रांतावर

praantik	प्रांतिक	प्रांतिक

prantik	प्रांतिक	प्रांतिक

pranteey	प्रंंतीय	प्रांतीय

prantiy	प्रंंतीय	प्रांतीय

prachin	प्राचीन	प्राचिन

prajakta	प्रजजक्त	प्राजक्ता

prajkta	प्रजजक्त	प्राजक्ता

pranahee	प्रणणही	प्राणही

pranahi	प्राणही	प्राणही

pranavar	प्राणावर	प्राणावर

pratah	प्रतता	प्रातः

pratha	प्रथथ	प्रातः

prayojakatv	प्रययोजकत्व	प्रायोजकत्व

prayojaktv	प्रययोजक््व	प्रायोजकत्व

prayojkatv	प्रययोजकत्व	प्रायोजकत्व

prayojktv	प्रययोजक््व	प्रायोजकत्व

planeet	प्लानेट	प्लॅनेट

planet	प्लानेट	प्लॅनेट

fandachya	फंदाच्या	फंडाच्या

fundachya	फुडाच्या	फंडाच्या

fandat	फाडतत	फंडात

fundat	फुडतत	फंडात

fakeera	फाीरा	फकिरा

fakira	फाीरा	फकिरा

phakeera	फाीरा	फकिरा

phakira	फाीरा	फकिरा

fateeh	फाीही	फतेह

fateh	फाेह	फतेह

fatteeh	फत्ही	फतेह

fatteh	फत्ही	फतेह

feteh	फाेह	फतेह

fetteh	फि्हे	फतेह

phateeh	फाीही	फतेह

phateh	फाेह	फतेह

phatteh	फत्हे	फतेह

pheteh	फाेहं	फतेह

farfat	फर्ा	फरफट

pharphat	फर्ट	फरफट

fargyusan	फर्ग्युसन	फर्ग्युसन

ferguson	फर्गससुसन	फर्ग्युसन

furgusan	फर्गससुसन	फर्ग्युसन

fadbhaji	फडभाजी	फळभाजी

falbhaaji	फलभाजी	फळभाजी

falbhaji	फलभाजी	फळभाजी

phadbhaji	फडभाजी	फळभाजी

phalbhaji	फलभाजी	फळभाजी

favaranee	फारराी	फवारणी

favarani	फारराी	फवारणी

favarni	फाररणी	फवारणी

phavarni	फाररणी	फवारणी

far	फरर	फार

phar	फरर	फार

farma	फरर्म	फार्मा

pharma	फरर्म	फार्मा

falani	फललणी	फाळणी

falni	फललणी	फाळणी

phalni	फललणी	फाळणी

falanicha	फललणीचा	फाळणीचा

falnicha	फालणीचा	फाळणीचा

falnichya	फललणीच्	फाळणीचा

phalnichya	फालणीच्	फाळणीचा

falaniche	फललणीचे	फाळणीचे

falniche	फललणीचे	फाळणीचे

phalniche	फललणीचे	फाळणीचे

falanichya	फललणीच्या	फाळणीच्या

falnichya	फललणीच्या	फाळणीच्या

phalnichya	फालणीच्या	फाळणीच्या

fadanimule	फडडणीमुळे	फाळणीमुळे

falnimule	फालणीमुळे	फाळणीमुळे

phalnimule	फालणीमुळे	फाळणीमुळे

finiesh	फिनिसिश	फिन्निश

finish	फिनिसिश	फिन्निश

finnies	फिनिसिय	फिन्निश

finniesh	फिनिसिश	फिन्निश

finnieshh	फिनिनिश	फिन्निश

finnis	फिनिसिस	फिन्निश

finnish	फिनिसिश	फिन्निश

finnishh	फिनिसिश	फिन्निश

phinish	फिनिस	फिन्निश

phinniesh	फिनिसिश	फिन्निश

phinnis	फिनिसिस	फिन्निश

phinnish	फिनिसिश	फिन्निश

phinnishh	फिनिसिश	फिन्निश

fifa	फिफा	फिफा

fifachya	फिफाच्या	फिफाच्या

feed	फीड	फीड

fid	फीड	फीड

fida	फिडा	फीड

fiid	फीड	फीड

pheed	फेड	फीड

phid	फाड	फीड

phida	फिडा	फीड

phiida	फीड	फीड

fukat	फुकत	फुकट

phookat	फुकत	फुकट

phukat	फुकत	फुकट

fulpakharanche	फुलपाखरांचे	फुलपाखरांचे

fulpakhranche	फुलपाखरांचे	फुलपाखरांचे

fulpakhranchey	फुलपाखरांचे	फुलपाखरांचे

phulpakharanche	फुल्ाखरांचे	फुलपाखरांचे

phulpakhranchey	फुल्ाखरांचे	फुलपाखरांचे

fulpakharanchya	फुल्ाखरांच्या	फुलपाखरांच्या

fulpakhranchya	फुलपाखरांच्या	फुलपाखरांच्या

phulpakharanchya	फुल्ाखरांच्या	फुलपाखरांच्या

phulpakhranchya	फुल्खखरांच्या	फुलपाखरांच्या

fulpakharala	फुल्ाखराला	फुलपाखराला

fulpakhraala	फुल्ाखराला	फुलपाखराला

phulpakharala	फुल्ाखर्ला	फुलपाखराला

phulpakhraala	फुल्ाखराला	फुलपाखराला

fairo	फारो	फेरो

fairoo	फारो	फेरो

faro	फररो	फेरो

feero	फिरो	फेरो

fero	फारो	फेरो

feroo	फेरो	फेरो

phairo	फारो	फेरो

pharo	फारो	फेरो

pheero	फेरो	फेरो

phero	फारो	फेरो

pheroo	फेरू	फेरो

facebaak	फॅकबाक	फेसबुक

facebook	फाकबूक	फेसबुक

facebooq	फाकबॉक	फेसबुक

facebuk	फाकबकक	फेसबुक

facebuq	फॅकबकक	फेसबुक

faceebook	फाकबूक	फेसबुक

faceebuk	फाकबकक	फेसबुक

fesabuk	फेसबकक	फेसबुक

phacebook	फाकबूक	फेसबुक

phacebuk	फाकबकक	फेसबुक

pheesabuk	फेसबँक	फेसबुक

phesabuk	फेसबँक	फेसबुक

phesabuka	फेसबुका	फेसबुक

phesabuq	फेसबँक	फेसबुक

freez	फ्रेझ	फ्रीज

fridge	फ्रिड	फ्रीज

baglow	बगलो	बंगलो

banglo	बागलो	बंगलो

bungalow	बंगला	बंगलो

bakharee	बखाी	बखरी

bakhari	बखाी	बखरी

bag	बा	बग

bug	बा	बग

bagal	बगळ	बगल

bageecha	बाीचा	बगीचा

bagicha	बाीचा	बगीचा

baghitala	बघितला	बघितला

baghitla	बघितला	बघितला

bataliyana	बॅललियन	बटालियन

battalian	बॅ्लियन	बटालियन

battalion	बटालियन	बटालियन

betaliyana	बॅललियन	बटालियन

bettalion	बेालियन	बटालियन

batu	बटू	बटु

badodekar	बदोदेकर	बडोदेकर

badhatya	बात्या	बढत्या

badhtya	बात्या	बढत्या

badak	बदक	बदक

badalave	बदलावे	बदलावे

badlave	बदलावे	बदलावे

bananaree	बनणारी	बनणारी

bananari	बनणारी	बनणारी

bannari	बन्ारी	बनणारी

banale	बनले	बनले

banle	बनले	बनले

banalela	बनलेला	बनलेला

banlela	बनलेला	बनलेला

banseelal	बन्सिललल	बन्सीलाल

bansilal	बं्सिललल	बन्सीलाल

barbaad	बर्ाद	बरबाद

barbad	बा्डद	बरबाद

barack	बरकक	बराक

baracq	बरकक	बराक

barak	बाकक	बराक

baraka	बरकका	बराक

baraq	बरकक	बराक

baraqa	बरकक	बराक

barrack	बर्क्	बराक

baraaha	बरहहा	बराहा

baraha	बरहह	बराहा

barobarinech	बरोबरीनचच	बरोबरीनेच

bargaman	बर्गमा	बर्गमन

bargman	बर्गमा	बर्गमन

bergman	बर्गमा	बर्गमन

barnsa	बर्नसस	बर्न्स

barnsha	बर्नशस	बर्न्स

bunrsh	बं्स	बर्न्स

burns	बर्न	बर्न्स

burnsh	बर्न	बर्न्स

barfal	बर्फलल	बर्फाळ

barma	बर्मा	बर्मा

berma	बर्मा	बर्मा

burma	बर्मा	बर्मा

bala	बाा	बला

balaa	बाा	बला

balache	बााचे	बलाचे

balane	बााने	बलाने

ballal	बल्लाल	बल्लाळ

bashee	बाी	बशी

bashi	बाी	बशी

basate	बसते	बसते

baste	बसते	बसते

basato	बसतो	बसतो

basto	बसतो	बसतो

basawava	बसवावा	बसवावा

basvava	बसवावा	बसवावा

baseel	बेील	बसेल

baseela	बसेला	बसेल

basel	बसील	बसेल

basela	बसेल	बसेल

bases	बसेस	बसेल

bashel	बाेल	बसेल

bashela	बसेला	बसेल

busel	बसील	बसेल

bahudha	बहुधा	बहुधा

baangdi	बांगडी	बांगडी

bangadee	बांगडी	बांगडी

bangadi	बांगडी	बांगडी

baandani	बांधणी	बांधणी

bandhanee	बंंधणी	बांधणी

bandhani	बांधणी	बांधणी

baandanichi	बांदणीची	बांधणीची

baandhaneechee	बांधणीची	बांधणीची

bandhanichi	बंंधणीची	बांधणीची

baandaniche	बांधणीचे	बांधणीचे

baandhaneeche	बांधणीचे	बांधणीचे

bandhaniche	बंंधणीचे	बांधणीचे

baandanichya	बांदणीच्या	बांधणीच्या

baandhaneechya	बांधणीच्या	बांधणीच्या

bandhanichya	बंंधणीच्या	बांधणीच्या

baandanisaathi	बांदणीसाठी	बांधणीसाठी

bandhaneesathee	बांधणीसाठी	बांधणीसाठी

bandhanisathi	बंंधणीसाठी	बांधणीसाठी

bandhavee	बांधववी	बांधावी

bandhavi	बांधववी	बांधावी

baankot	बांकोत	बाणकोट

bancoat	बनंकोत	बाणकोट

bankot	बँंखोत	बाणकोट

badashaha	बददशहा	बादशहा

badshaha	बदळशहा	बादशहा

badshha	बाद्ा	बादशहा

badashahachya	बददशहाच्या	बादशहाच्या

badshahachya	बददशााच्या	बादशहाच्या

badshhachya	बददशा्च्या	बादशहाच्या

badashahane	बददशहाने	बादशहाने

badshahane	बददशहाने	बादशहाने

baburao	बाबूराव	बाबुराव

baburav	बाबूराव	बाबुराव

babhadgaon	बाभागाव	बाभळगाव

babhadgav	बाभागाव	बाभळगाव

babhalagav	बाभलगाव	बाभळगाव

bhabhalgaon	भाभागाव	बाभळगाव

baravya	बररवव्या	बाराव्या

barshee	बारशसी	बार्शी

barshi	बररशसी	बार्शी

barsheet	बररशशीत	बार्शीत

barshit	बररशसित	बार्शीत

balakancha	बालकांचा	बालकांचा

balakanchee	बालकांची	बालकांची

balakanchi	बालकांची	बालकांची

balakanchya	बालकांच्या	बालकांच्या

balakanna	बाळकांना	बालकांना

balakacha	बाळकाचा	बालकाचा

balkacha	बाळकाचा	बालकाचा

balakachee	बाळकाची	बालकाची

balakachi	बाळकाची	बालकाची

balkachi	बाळकाची	बालकाची

balakas	बाळकास	बालकास

balkas	बाळकास	बालकास

balageet	बाळगीत	बालगीत

balgeet	बाळगीत	बालगीत

balaghat	बाळघघात	बालाघाट

balaghatachya	बाळघठाचाच्या	बालाघाटाच्या

balghatachya	बाळघठाचाच्या	बालाघाटाच्या

bavane	बावाे	बावणे

bavne	बावणे	बावणे

bawne	बावणे	बावणे

basamati	बससमती	बासमती

basamatii	बससमती	बासमती

basameti	बससमेी	बासमती

basmatee	बससमती	बासमती

basmati	बास्ाी	बासमती

basmatii	बास्ाी	बासमती

basmetee	बास्ेी	बासमती

basmeti	बससमेी	बासमती

bicharee	बिचारी	बिचारी

bichari	बिचारी	बिचारी

been	बीन	बिन

biin	बीन	बिन

bin	बीन	बिन

beena	बीना	बिना

biina	बीना	बिना

bina	बीना	बिना

bimal	बिमल	बिमल

biroba	बिरोबा	बिरोबा

baadha	बाधाधा	बुद्ध

boodh	बुध	बुद्ध

buddh	बुद्ध	बुद्ध

buddha	बुद्ध	बुद्ध

budh	बुध	बुद्ध

buddhancha	बुद्धांचा	बुद्धांचा

buddhanche	बुद्धांचे	बुद्धांचे

budhanche	बुधाधांचे	बुद्धांचे

buddhanchya	बुद्धांच्या	बुद्धांच्या

buddhana	बुद्धानना	बुद्धांना

buddhanna	बुद्धांना	बुद्धांना

buddhanni	बुद्धांनी	बुद्धांनी

budhannee	बुधाधांनी	बुद्धांनी

budhanni	बुध्धांनी	बुद्धांनी

buddhachi	बुद्धाची	बुद्धाची

buddhala	बुद्धलला	बुद्धाला

budhkar	बुधका	बुधकर

buldhana	बुलधाना	बुलढाणा

bank	बँँक	बॅंक

back	बकक	बॅक

bacq	बॉक	बॅक

bak	बाक	बॅक

baq	बाक	बॅक

betee	बेटी	बेटी

beti	बेटी	बेटी

badar	बादर	बेडर

badeer	बादर	बेडर

bader	बेदर	बेडर

bedar	बेदर	बेडर

beedar	बेदर	बेडर

bebanav	बेबनाव	बेबनाव

bebnav	बबबनाव	बेबनाव

baby	बाबी	बेबी

bebee	बेबी	बेबी

bebi	बेबी	बेबी

bebii	बेबी	बेबी

beby	बेबी	बेबी

beebee	बिबी	बेबी

beebi	बाबी	बेबी

beeby	बाबी	बेबी

belsare	बेलसरे	बेलसरे

belgium	बेल्गियम	बेल्जियम

belgiumchya	बेलगगीममच्या	बेल्जियमच्या

behare	बेहरे	बेहरे

behere	बेहेे	बेहरे

baksha	बाक्स	बॉक्स

baqsa	बकक्स	बॉक्स

bauks	बॉक्स	बॉक्स

bauksh	बुक्स	बॉक्स

bauqs	बॉक्स	बॉक्स

bax	बकक्स	बॉक्स

boks	बॉक्स	बॉक्स

box	बॉक्स	बॉक्स

baksar	बाक्सर	बॉक्सर

bakser	बाक्सर	बॉक्सर

baqsar	बाक्सर	बॉक्सर

baxer	बाक्सर	बॉक्सर

boksar	बोक्सर	बॉक्सर

bokser	बॉक्सर	बॉक्सर

boqser	बॉक्सर	बॉक्सर

boxar	बॉक्सर	बॉक्सर

boxer	बॉक्सर	बॉक्सर

bab	बाब	बॉब

baub	बॉब	बॉब

bob	बाब	बॉब

babbi	बबबी	बॉबी

babi	बाबी	बॉबी

babii	बाबी	बॉबी

baby	बाबी	बॉबी

baubbi	बाबी	बॉबी

baubbii	बॉबी	बॉबी

baubi	बाबी	बॉबी

baubie	बाबी	बॉबी

baubiie	बाबी	बॉबी

bauby	बाबी	बॉबी

bobbi	बबबी	बॉबी

bobbie	बाब्	बॉबी

bobbii	बबबी	बॉबी

bobbiie	बबबी	बॉबी

bobby	बाबी	बॉबी

bobi	बाबी	बॉबी

bobie	बाबी	बॉबी

boby	बाबी	बॉबी

bobhata	बोभतता	बोभाटा

bor	बोर	बोर

bore	बोरे	बोर

borachee	बोरचची	बोराची

borachi	बोरचची	बोराची

borivalee	बोरीवाी	बोरिवली

borivali	बोरीवाी	बोरिवली

board	बार्ड	बोर्ड

booard	बोर्ड	बोर्ड

boord	बरर्ड	बोर्ड

boorda	बोर्ड	बोर्ड

bord	बरर्ड	बोर्ड

borda	बोर्ड	बोर्ड

boardchya	बारदडच्या	बोर्डच्या

bordchya	बोरदडच्या	बोर्डच्या

boardachi	बोरदडचची	बोर्डाची

bordachee	बोरदडचची	बोर्डाची

boardache	बोरदडचचे	बोर्डाचे

bordache	बोरदडचचे	बोर्डाचे

boardachya	बोरदडचच्या	बोर्डाच्या

bordachya	बोरदडचच्या	बोर्डाच्या

boardateel	बोरदडातील	बोर्डातील

boardatil	बोरदडातील	बोर्डातील

bordateel	बोरदडततील	बोर्डातील

boardane	बारदडनने	बोर्डाने

bordane	बोरदडाने	बोर्डाने

bolaka	बोलका	बोलका

bolka	बोलका	बोलका

bolanyachee	बोलण्याची	बोलण्याची

bolanyachi	बोलण्याची	बोलण्याची

bolanyache	बोलण्याचे	बोलण्याचे

bolanyachya	बोलण्याच्या	बोलण्याच्या

bolanyatoon	बोलण्यातून	बोलण्यातून

bolanyatun	बोलण्यातून	बोलण्यातून

bolanyamule	बोलण्यामुळे	बोलण्यामुळे

bolanyasathee	बोलण्यासाठी	बोलण्यासाठी

bolanyasathi	बोलण्यासाठी	बोलण्यासाठी

boling	बॉलिंग	बोलिंग

bowling	बॉविंग	बोलिंग

braun	ब्रूउन	ब्राऊन

brown	ब्रॉझन	ब्राऊन

braahman	ब्राह्मण	ब्राह्मण

brahman	ब्रहह्मण	ब्राह्मण

brahmana	ब्राह्मण	ब्राह्मण

bramhan	ब्राम्मण	ब्राह्मण

brahmanancha	ब्रमह्मणांचा	ब्राह्मणांचा

bramhanancha	ब्रमम्मणांचा	ब्राह्मणांचा

brahmananche	ब्रहह्मणांचे	ब्राह्मणांचे

bramhananche	ब्रहम्मणांचे	ब्राह्मणांचे

brahmanache	ब्रहह्मणचचे	ब्राह्मणाचे

bramhanache	ब्रहम्मणचचे	ब्राह्मणाचे

brahmanachya	ब्रहम्मणाच्या	ब्राह्मणाच्या

bramhanachya	ब्रमम्मणाच्या	ब्राह्मणाच्या

brahmanat	ब्रहह्मणात	ब्राह्मणात

bramhanat	ब्रमम्मणात	ब्राह्मणात

brahmanala	ब्रहह्मणलला	ब्राह्मणाला

bramhanala	ब्रमम्मणलला	ब्राह्मणाला

brahmanee	ब्रहह्मणी	ब्राह्मणी

bramhani	ब्राम्मणी	ब्राह्मणी

britainche	ब्रिटाचे	ब्रिटनचे

britanache	ब्रिटााे	ब्रिटनचे

britainchya	ब्रिटाच्या	ब्रिटनच्या

britanachya	ब्रिटाा्या	ब्रिटनच्या

britainmadhil	ब्रिटेेधील	ब्रिटनमधील

britanamadheel	ब्रिटााधील	ब्रिटनमधील

britanamdheel	ब्रिटााधील	ब्रिटनमधील

britainmadhye	ब्रिटामध्ये	ब्रिटनमध्ये

britanamadhye	ब्रिटााध्ये	ब्रिटनमध्ये

briitanii	ब्रिटाी	ब्रिटनी

briittany	ब्रिटा्	ब्रिटनी

britani	ब्रिटाी	ब्रिटनी

brittani	ब्रिट्ि	ब्रिटनी

brittany	ब्रिटा्	ब्रिटनी

blaad	ब्ला	ब्लड

blad	ब्ला	ब्लड

blood	ब्लू	ब्लड

blud	ब्लू	ब्लड

blacks	ब्लॉक्स	ब्लॉक्स

blaks	ब्लाक्स	ब्लॉक्स

blaqs	ब्लाक्स	ब्लॉक्स

blocks	ब्लॉक्स	ब्लॉक्स

blocqs	ब्लॉक्स	ब्लॉक्स

bhangarat	भागररात	भंगारात

bhaktibhaav	भा्तिभाव	भक्तिभाव

bhaktibhav	भक्तिभाव	भक्तिभाव

bhaksh	भक्ष	भक्ष

bhaksha	भक्ष	भक्ष

bhakshak	भक्षक	भक्षक

bhagavantanchee	भगवंतांची	भगवंतांची

bhagvantanchi	भगवंतांची	भगवंतांची

bhagwantanchi	भगवंतांची	भगवंतांची

bhagavantache	भगवाताचे	भगवंताचे

bhagvantache	भगवाताचे	भगवंताचे

bhagwantache	भगवाताचे	भगवंताचे

bhageeni	भाीनी	भगिनी

bhaginee	भािनी	भगिनी

bhagini	भािनी	भगिनी

bhanage	भागे	भणगे

bhange	भााे	भणगे

bhangey	भागे	भणगे

bhannge	भााे	भणगे

bhadrakaali	भा्रकाली	भद्रकाली

bhadrakali	भा्रकाली	भद्रकाली

bhadra	भद्र	भद्रा

bhadraa	भद्रा	भद्रा

bharavite	भरविते	भरविते

bharvite	भरविते	भरविते

bharavila	भरविला	भरविला

bharvila	भरविला	भरविला

bharavilee	भरविली	भरविली

bharvili	भरविली	भरविली

bhalateekadech	भातीकडेच	भलतीकडेच

bhalteekadech	भातीकडेच	भलतीकडेच

bhaltikadech	भातिकडेच	भलतीकडेच

bhavan	भाा	भवन

bhavanachya	भाााच्या	भवनाच्या

bhavanat	भााात	भवनात

bhavanateel	भानातील	भवनातील

bhavanatil	भानातील	भवनातील

bhavaneecha	भाानीचा	भवानीचा

bhavanicha	भाानीचा	भवानीचा

bhasin	भाीन	भसीन

bhandanat	भांडणात	भांडणात

bhandnat	भांडणात	भांडणात

bhandi	भांडी	भांडीं

bhandin	भांडीण	भांडीं

bhaubeej	भौऊबीज	भाऊबीज

bhaubij	भौऊबीज	भाऊबीज

bhauubij	भौऊबीज	भाऊबीज

bhaajyanche	भाज्यांचे	भाज्यांचे

bhajyanche	भाज्यांचे	भाज्यांचे

bhatiya	भातिया	भाटिया

bhade	भादे	भाडे

bhanushali	भानुषाली	भानुशाली

bharatasah	भारतासह	भारतासह

bhashyakar	भाष्यकरर	भाष्यकार

bhaskarrao	भास्करराव	भास्करराव

bhingaree	भिंगरी	भिंगरी

bhingari	भिंगरी	भिंगरी

bhingri	भिंग्ी	भिंगरी

bhikkhu	भिक्खू	भिक्खु

bhijat	भिजत	भिजत

bhijlee	भिजली	भिजली

bhijli	भिजली	भिजली

bhijavoon	भिजाून	भिजवून

bhijvoon	भीजवून	भिजवून

bhijvun	भीज्ून	भिजवून

bhivandeet	भिवंडीत	भिवंडीत

bhivandit	भिवंदीत	भिवंडीत

bhiwandit	भिवंडीत	भिवंडीत

bheeteene	भितीने	भीतीने

bheetine	भितीने	भीतीने

bhitine	भितीने	भीतीने

bheetimule	भितीमुळे	भीतीमुळे

bhiteemule	भितीमुळे	भीतीमुळे

bhitimule	भितीमुळे	भीतीमुळे

bhujang	भुजंग	भुजंग

bhurdand	भुरददाद	भुर्दंड

bhurdanda	भुरददाद	भुर्दंड

bhuvaya	भुवया	भुवया

bhookamp	भूकाप	भूकंप

bhookanp	भूकाप	भूकंप

bhukamp	भूकाप	भूकंप

bhookampapravan	भूकमपर्रवा	भूकंपप्रवण

bhukamppravan	भुकापप्रवा	भूकंपप्रवण

bhukanpapravan	भुकापा्रवा	भूकंपप्रवण

bhookampache	भूकमपाचे	भूकंपाचे

bhookanpache	भूकापाचे	भूकंपाचे

bhukampache	भूकापाचे	भूकंपाचे

bhookampat	भूकापतत	भूकंपात

bhukampaat	भूकापात	भूकंपात

bhookampanantar	भूकमपननंतर	भूकंपानंतर

bhookanpannatar	भूकापननातर	भूकंपानंतर

bhukampanantar	भुकमपननंतर	भूकंपानंतर

bhookampane	भूकापाने	भूकंपाने

bhookanpane	भूकापाने	भूकंपाने

bhukampane	भूकापाने	भूकंपाने

bhootakalat	भूतकालतत	भूतकाळात

bhootkalaat	भूतकाळात	भूतकाळात

bhootkalat	भूतकाळात	भूतकाळात

bhootakalateel	भूतकालततील	भूतकाळातील

bhootkalateel	भूतकालततील	भूतकाळातील

bhoodal	भूदा	भूदल

bhudal	भुदा	भूदल

bhoomiheen	भूमिहीन	भूमिहीन

bhoosthir	भूष्थिर	भूस्थिर

bhusthir	भूष्थिर	भूस्थिर

bheteechya	भेटीच्या	भेटीच्या

bhetichya	भेटीच्या	भेटीच्या

bheteet	भेटीत	भेटीत

bhetit	भेटीत	भेटीत

bheteela	भेटीला	भेटीला

bhetila	भेटीला	भेटीला

bheteesathee	भेटीसाठी	भेटीसाठी

bhetisathi	भेटीसाठी	भेटीसाठी

bhedabhav	भेदााव	भेदभाव

bhedbhav	भेदभाव	भेदभाव

bhokare	भोकरे	भोकरे

bhokre	भोकरे	भोकरे

bhogavati	भोगववती	भोगावती

bhogawati	भोगववती	भोगावती

bhogeeley	भोगीली	भोगिले

bhogile	भोगीले	भोगिले

bhogiley	भोगीली	भोगिले

bhograj	भोगराज	भोजराज

bhojraaj	भोजराज	भोजराज

bhojraj	भोजराज	भोजराज

mangadyaan	मंगळ्ान	मंगळयान

mangalyan	मंगल्ान	मंगळयान

mangdyaan	मंग््ान	मंगळयान

mangalagauree	मंगलागौरी	मंगळागौरी

mangalagauri	मंगळागौरी	मंगळागौरी

mangdagauree	मंगळागौरी	मंगळागौरी

mangdagauri	मंगळागौरी	मंगळागौरी

manjoor	मंजूर	मंजुर

manjur	मंजूर	मंजुर

mandirahi	मंदीरही	मंदिरही

mandirache	मंदीराचचे	मंदिरांचा

mandirancha	मंदीरांचा	मंदिरांचा

mandirachi	मंदीराचची	मंदिरांची

mandiranchi	मंदीरांची	मंदिरांची

mandirant	मंदीरांत	मंदिरांत

mandirana	मंदिरानना	मंदिरांना

mandiranna	मंदिरांना	मंदिरांना

mandiranvar	मंडीरांवर	मंदिरांवर

mandirachi	मंदीराची	मंदिराची

mandirache	मंदीराचे	मंदिराचे

mandiravar	मंदीरावर	मंदिरावर

mandiravareel	मंदिरावरील	मंदिरावरील

mandiravaril	मंदिरावरील	मंदिरावरील

mandiravishayi	मंदीराविषयी	मंदिराविषयी

mandiravishyi	मंदिराविष्ी	मंदिराविषयी

mandiras	मंदिरास	मंदिरास

mandiri	मंदीरी	मंदिरी

majalyavar	मजल्यावर	मजल्यावर

majlyavar	मजल्यावर	मजल्यावर

majuranchya	मजुरांच्या	मजुरांच्या

majuranna	मजुरांना	मजुरांना

majuranvar	माुरांवर	मजुरांवर

majjav	मज्जाव	मज्जाव

matacha	मताचा	मताचा

matadhikya	मााधिक्य	मताधिक्य

matadhikyane	मााधिक्याने	मताधिक्याने

matanusar	मतानुसार	मतानुसार

madatahi	मदतही	मदतही

madathee	मदाीी	मदतही

madathi	मदाीी	मदतही

maneesha	मनेशा	मनीषा

manisha	मनिष	मनीषा

manogat	मनोगा	मनोगत

manoget	मनोगत	मनोगत

maratha	मााठा	मराठा

maretha	मााठा	मराठा

maratheet	मराठीत	मराठीत

marathit	मराठीत	मराठीत

marathiteet	मराठीती	मराठीत

marathitit	मराठीती	मराठीत

maratheetale	मराठीतले	मराठीतले

marathitale	मराठीतले	मराठीतले

marathitaley	मराठीतले	मराठीतले

maryadeche	मा्यादेचे	मर्यादेचे

maryademule	मा्यादेमुळे	मर्यादेमुळे

maalaya	मााय	मलाया

malaaya	मलाया	मलाया

malaya	मलयय	मलाया

maltipal	मल्टिपा	मल्टिपल

multiple	मु्टिपले	मल्टिपल

malhararao	मा्हारााव	मल्हारराव

malhararav	मा्हररााव	मल्हारराव

malharrao	मा्हारााव	मल्हारराव

malhararavannee	मा्हाराावांनी	मल्हाररावांनी

malhararavanni	मा्हरराावांनी	मल्हाररावांनी

malharraonni	मा्हाराांांनी	मल्हाररावांनी

malhotra	मा्होट्रा	मल्होत्रा

malamala	मलमाा	मळमळ

malmal	मलमल	मळमळ

maval	मालल	मवाळ

masarum	मसरूम	मशरूम

masharum	मशरूम	मशरूम

masharuum	मशरूम	मशरूम

mashharum	मशाूम	मशरूम

mushhroom	मु्ूम	मशरूम

mushraam	मु््म	मशरूम

mushroom	मु्ूम	मशरूम

mushrum	मु्ूम	मशरूम

mushruum	मु्ूम	मशरूम

musroom	मु्ूम	मशरूम

muushroom	मु्ूम	मशरूम

machine	माीने	मशिन

mashin	माीन	मशिन

mast	मा्त	मस्ट

must	मू्त	मस्ट

mahant	महात	महंत

mahat	महात	महंत

mahamad	महममद	महंमद

mahanmad	महनमद	महंमद

mahanmd	महामद	महंमद

mahmad	महमम	महंमद

mahapurush	महापूरुष	महापुरुष

mahapurushaanchi	महापूरूषांची	महापुरुषांची

mahapurushanchee	महापुरुषांची	महापुरुषांची

mahapurushanchi	महापूरूषांची	महापुरुषांची

mahapurushanchya	महापूरूषांच्या	महापुरुषांच्या

mahapurushacha	महापूरूषाचाया	महापुरुषाच्या

mahapurushachya	महापूरूषाच्या	महापुरुषाच्या

mahaprasadaache	महाप्रसादाचे	महाप्रसादाचे

mahaprasadache	महाप्रसादाचे	महाप्रसादाचे

mahapran	महाप्रणण	महाप्राण

mahabalee	महाबाी	महाबली

mahabali	महाबाी	महाबली

mahaaraashhtra	महाराष्ट्र	महाराष्ट्र

mahaaraashtra	महाराष्ट्र	महाराष्ट्र

mahaaraastra	महारास्ट्र	महाराष्ट्र

maharashhtra	महाराष्ट्र	महाराष्ट्र

maharashtra	महारषष्ट्र	महाराष्ट्र

maharastra	महारसस्ट्र	महाराष्ट्र

maharashtrachya	महाराष्ट्राच्या	महाराष्ट्राच्या

maharashtrat	महाराष्ट्रात	महाराष्ट्रात

maharashtrapasoon	महाराष्ट्रापासून	महाराष्ट्रापासून

maharashtrapasun	महाराष्ट्रापासून	महाराष्ट्रापासून

maharashtrasaathi	महाराष्ट्रससाठी	महाराष्ट्रासाठी

maharashtrasathi	महाराष्ट्रससाठी	महाराष्ट्रासाठी

maharashtreey	महाराष्ट्रीय	महाराष्ट्रीय

maharashtriy	महाराष्ट्रीय	महाराष्ट्रीय

maharashtriya	महाराष्ट्रीय	महाराष्ट्रीय

maharudra	महारुद्र	महारुद्रा

mahasfot	महससफफोट	महास्फोट

mahasphot	महससफफोट	महास्फोट

manjarekar	मंंजरेकर	मांजरेकर

manjrekar	मांजरेकर	मांजरेकर

maandkey	मांडकी	मांडके

mandake	मांडके	मांडके

mandkay	मांडके	मांडके

mandkey	मांडकी	मांडके

magachi	मागची	मागची

magchi	मागची	मागची

maagnyachi	मागण्याची	मागण्याची

maganyachi	मागण्याची	मागण्याची

magnyachi	मागण्याची	मागण्याची

maganyat	मागण्यात	मागण्यात

magnyat	मागण्यात	मागण्यात

maganyas	मागण्यास	मागण्यास

magnyas	मागण्यास	मागण्यास

maganyasathi	मागण्यासाठी	मागण्यासाठी

magnyasathi	मागण्यासाठी	मागण्यासाठी

magasvargiy	मागससवर्गीय	मागासवर्गीय

magasvargiya	मागसस्र्गीय	मागासवर्गीय

magasvargiyachya	मागससवर्गीचचचच्या	मागासवर्गीयांच्या

magasvargiyanchya	मागसस्र्गींंंच्या	मागासवर्गीयांच्या

magasvargiyansathi	मागास्ा्गीतंंसाठी	मागासवर्गीयांसाठी

magomag	मॅगोमगग	मागोमाग

magh	मघघ	माघ

machikade	मचचिकडे	माचीकडे

machichya	माचीच्या	माचीच्या

machila	माचीला	माचीला

machivar	मचचीवर	माचीवरील

machivaril	मचचीवरील	माचीवरील

matunga	मातुंग	माटुंगा

maatecha	मातेचा	मातेचा

matecha	मततेचा	मातेचा

maatechi	मातेची	मातेची

matechi	मातेची	मातेची

matha	मठथा	माथा

madagascar	माडगगसस्कर	मादागास्कर

madagaskar	माडगगससकका	मादागास्कर

madagaskara	माळगगससकका	मादागास्कर

madagasqar	माडगगससककर	मादागास्कर

madagasqara	माडगगससककर	मादागास्कर

maargika	मार्गिक	मार्गिका

margika	मार्गिक	मार्गिका

maldiv	मालदीव	मालदीव

maldive	मालदीवे	मालदीव

maldivchya	मालदीवच्या	मालदीवच्या

malad	मललदद	मालाड

malasathi	मललासाठी	मालासाठी

maalta	मालतट	माल्टा

maaltaa	मालतता	माल्टा

malta	मालतट	माल्टा

maltaa	मालतता	माल्टा

maava	मावा	मावा

mava	मावा	मावा

maasaymaari	मासामारी	मासेमारी

masaymaari	मससामारी	मासेमारी

masemari	मससेमारी	मासेमारी

maasaymarichey	मासामारीचे	मासेमारीचे

masemariche	मासममररीचे	मासेमारीचे

masemarichey	मासेमररीचे	मासेमारीचे

maasemarichya	मासेमररीच्या	मासेमारीच्या

masaymarichya	मससामारीच्या	मासेमारीच्या

masemarichya	मससेमररीच्या	मासेमारीच्या

maasaymaariver	मासामारीवर	मासेमारीवर

masaymaariver	मससामारीवर	मासेमारीवर

masemarivar	मससेमररीवर	मासेमारीवर

maashtar	मास्टर	मास्टर

maashter	माश्टर	मास्टर

maastar	मास्तर	मास्टर

maaster	मास्टर	मास्टर

mashtara	मास्टे	मास्टर

mashter	माश्टर	मास्टर

mastar	मसस्तर	मास्टर

mastara	मसस्टर	मास्टर

master	मसस्टर	मास्टर

mashtarsh	मॅस्टर्स	मास्टर्स

mashtarsha	मास्टर्स	मास्टर्स

mashtersh	मॅस्टर्स	मास्टर्स

mastars	मसस्टर्स	मास्टर्स

mastarsa	मास्टर्स	मास्टर्स

masters	मॅस्टर्स	मास्टर्स

mickey	मिकी	मिकी

micky	मिकी	मिकी

miikee	मिके	मिकी

miikii	मिकी	मिकी

mikee	मिके	मिकी

miki	मिकी	मिकी

mikii	मिकी	मिकी

miqee	मिके	मिकी

miqi	मिकी	मिकी

mit	मित	मित

mitt	मित्	मित

mithila	मिथिला	मिथिला

miravanukis	मिरवणुकीस	मिरवणुकीस

miravnukis	मिरवणुकीस	मिरवणुकीस

mirasdar	मिरससदार	मिरासदार

mirzapur	मिर्झापूर	मिर्झापूर

milian	मिलियन	मिलियन

milion	मिलिओन	मिलियन

miliyan	मिलियन	मिलियन

miliyon	मिलियन	मिलियन

millan	मिलनअन	मिलियन

millian	मिलियन	मिलियन

million	मिलिओन	मिलियन

milliyan	मिलियन	मिलियन

milliyon	मिलियन	मिलियन

midvinaari	मिळविणारी	मिळविणारी

midvinari	मिळविणारी	मिळविणारी

milavinari	मिळविणारी	मिळविणारी

misadtaat	मिसळतात	मिसळतात

misalatat	मिसळतात	मिसळतात

misaltat	मिसळतात	मिसळतात

meetarache	मिताचे	मीटरचे

meetarche	मिताचे	मीटरचे

meterche	मातरचे	मीटरचे

meetarachya	मिताच्या	मीटरच्या

meetarchya	मिताच्या	मीटरच्या

meterchya	मेतरच्या	मीटरच्या

meetaramadhye	मितााध्ये	मीटरमध्ये

meetarmadhye	मिता्ध्ये	मीटरमध्ये

metermadhye	मेटर्ध्ये	मीटरमध्ये

meediyavar	मेडियावर	मीडियावर

meerabai	मेराबाई	मीराबाई

mirabai	मिराबाई	मीराबाई

mungya	मुंग्य	मुंग्या

mukkam	मुक्कमम	मुक्काम

mukkamat	मुक्कममात	मुक्कामात

mukkamee	मुक्कममी	मुक्कामी

mukkami	मुक्कममी	मुक्कामी

mukti	मुक्ती	मुक्ति

mooni	मूनी	मुनी

moonii	मननी	मुनी

munee	मुनी	मुनी

muni	मुनी	मुनी

munii	मुनी	मुनी

muneennee	मुनींनी	मुनींनी

muninni	मुनींनी	मुनींनी

munnabhai	मुन्नाभाई	मुन्नाभाई

murtee	मूर्ती	मुर्ती

murti	मूर्ती	मुर्ती

murteechee	मूर्तीची	मुर्तीची

murtichi	मूर्तीची	मुर्तीची

mul	मूळ	मुलं

mulam	मुला	मुलं

mulaant	मुलांत	मुलांत

mulant	मुलांत	मुलांत

mulanpaikee	मुलांपैकी	मुलांपैकी

mulanpaiki	मुलांपैकी	मुलांपैकी

mulansathee	मुलांसाठी	मुलांसाठी

mulansathi	मुलांसाठी	मुलांसाठी

mulakhatee	मुलाखती	मुलाखती

mulakhati	मुलाखती	मुलाखती

mulakhateechya	मुलाखतीच्या	मुलाखतीच्या

mulakhatichya	मुलाखतीच्या	मुलाखतीच्या

mulakhateehee	मुलाखतीही	मुलाखतीही

mulakhatihi	मुलाखतीही	मुलाखतीही

mulukh	मुलुख	मुलुख

mudaskat	मुळससका	मुळासकट

mulasakat	मुलससका	मुळासकट

mooth	मूठ	मूठ

muth	मठठ	मूठ

moorkh	मुरखख	मूर्ख

murkh	मुरखख	मूर्ख

moorcha	मूर्च	मूर्च्छा

moorchchha	मूरचचचछा	मूर्च्छा

murcha	मूर्चाय	मूर्च्छा

murchha	मूर्चचय	मूर्च्छा

marathon	मॅरेथॉन	मॅरॅथॉन

mendu	मेंदू	मेंदू

menducha	मेंदूचा	मेंदूचा

menduche	मेंदूचे	मेंदूचे

menduchya	मेंदूच्या	मेंदूच्या

mendut	मेंदूत	मेंदूत

menduteel	मेंडूतील	मेंदूतील

mendutil	मेंडूतील	मेंदूतील

mendumadhye	मेंदूमध्ये	मेंदूमध्ये

mendula	मेंदूला	मेंदूला

make	मेक	मेक

meeksikan	मेक्सिकन	मेक्सिकन

meexican	मेक्सिकन	मेक्सिकन

meexikan	मेक्सिकन	मेक्सिकन

meksican	मेक्सिकन	मेक्सिकन

meksikan	मेक्सिकन	मेक्सिकन

meqsiqan	मेक्सिकन	मेक्सिकन

mexican	मेक्सिकन	मेक्सिकन

mexikan	मेक्सिकन	मेक्सिकन

mexiqan	मेक्सिकन	मेक्सिकन

megan	मेगन	मेगन

mait	मित	मेट

mate	माट	मेट

matee	माट	मेट

meet	मिट	मेट

met	मिट	मेट

mete	माट	मेट

maits	मेट्स	मेट्स

meetas	मॅटसस	मेट्स

meets	मेट्स	मेट्स

metas	मॅटसस	मेट्स

mets	मॅट्स	मेट्स

main	मेन	मेण

men	मेन	मेण

menachay	मेनाचे	मेणाचे

menache	मेनाचे	मेणाचे

mael	मेल	मेल

mail	मैल	मेल

male	माले	मेल

malee	मलली	मेल

meel	मेल	मेल

meela	मेल	मेल

mel	मेल	मेल

mela	मेला	मेल

mele	मेळे	मेले

mehanati	मेहनाी	मेहनती

mehanti	मेहणती	मेहनती

mehnati	मेहनाी	मेहनती

mehsaana	मेहसूना	मेहसाणा

mehsana	मेहसनना	मेहसाणा

maidanacha	मैदानाचा	मैदानाचा

maidanat	मैदानात	मैदानात

maidanateel	मैदानातील	मैदानातील

maidanatil	मैदानातील	मैदानातील

maidane	मैदाने	मैदाने

motha	मोठा	मोठं

moteeram	मोतीराम	मोतीराम

motiram	मोतीराम	मोतीराम

moteelal	मोटीलाल	मोतीलाल

motilal	मोटिलाल	मोतीलाल

mobail	मोबाईल	मोबाइल

mobel	मोबाईल	मोबाइल

mobile	मोबाईल	मोबाइल

moobail	मोबाईल	मोबाइल

moobile	मोबाईल	मोबाइल

mobilechi	मोबाईलची	मोबाइलची

momeen	मॉमनन	मोमीन

momin	मॉमिन	मोमीन

moore	मोर	मोरे

moorey	मोर	मोरे

more	मोर	मोरे

moree	मोरी	मोरे

moreey	मोरी	मोरे

morei	मोर	मोरे

morey	मोर	मोरे

moreni	मोराननी	मोरेंनी

morennee	मॉरांनी	मोरेंनी

morenni	मररांनी	मोरेंनी

mooresbi	मुरेसबबी	मोरेस्बी

mooresbie	मुरेसबबी	मोरेस्बी

mooresby	मुरेसबबी	मोरेस्बी

moreesbi	मॉरेसबबी	मोरेस्बी

moreesbiee	मॉरेसबबी	मोरेस्बी

moreesby	मॉरेसबबी	मोरेस्बी

moresbi	मोरेसबबी	मोरेस्बी

moresbie	मॉरेसबबी	मोरेस्बी

moresbii	मोरेसबबी	मोरेस्बी

moresbiie	मॉरेसबबी	मोरेस्बी

moresby	मॉरेसबबी	मोरेस्बी

moorle	मुरलल	मोर्ले

moorley	मूरलली	मोर्ले

morle	मोरलल	मोर्ले

morlee	मोरलली	मोर्ले

morleey	मररलले	मोर्ले

morlei	मोरलली	मोर्ले

morley	मोरलली	मोर्ले

mosamee	मोसमी	मोसमी

mosami	मोसमी	मोसमी

mohimecha	मोहिमेचा	मोहिमेचा

mohimechya	मोहिमेच्या	मोहिमेच्या

mohimet	मोहिम्त	मोहिमेत

mohimeteel	मोहिमेतील	मोहिमेतील

mohimetil	मोहिमेतील	मोहिमेतील

mohimedaramyan	मोहिमेदरम्यान	मोहिमेदरम्यान

mohimedarmyan	मोहिमेदरम्यान	मोहिमेदरम्यान

mohimemadhye	मोहिमेमध्ये	मोहिमेमध्ये

mohimes	मोहिम्स	मोहिमेस

maulyavaan	मौल्यवान	मौल्यवान

maulyavan	मूल्याान	मौल्यवान

moulyavan	मूल्यवान	मौल्यवान

myaanmaar	म्यांमार	म्यानमार

myanamara	म्यानाारा	म्यानमार

myanmar	म्यांंार	म्यानमार

myanmaarchya	म्यांमार््या	म्यानमारच्या

myanmarchya	म्यां्ार््या	म्यानमारच्या

myanmaarmadhye	म्यांमार्ध्ये	म्यानमारमध्ये

myanmarmadhye	म्यांमार्ध्ये	म्यानमारमध्ये

mhanatat	म्हणतात	म्हणतात

mhais	म्हैस	म्हैस

yayaati	ययाती	ययाति

yayati	ययतती	ययाति

yashamuday	याामुळे	यशामुळे

yashamule	याामुळे	यशामुळे

yanchyakadoon	यांच्याकडून	यांच्याकडून

yanchyakadun	यांच्याकडून	यांच्याकडून

yanchyakadoonahi	यांच्याकडूनही	यांच्याकडूनही

yanchyakadunahi	यांच्याकडूनही	यांच्याकडूनही

yanchyakadunhi	यांच्याकडूंीी	यांच्याकडूनही

yanchyakade	यांच्याकडे	यांच्याकडे

yanchyach	यांच्याच	यांच्याच

yanchyat	यांच्यात	यांच्यात

yanchyadaramyan	यांच्यादरम्यान	यांच्यादरम्यान

yanchyadarmyan	यांच्यादर््यान	यांच्यादरम्यान

yanchyanantar	यांच्यानंतर	यांच्यानंतर

yanchyapasoon	यांच्यापासून	यांच्यापासून

yanchyapasun	यांच्यापासून	यांच्यापासून

yanchyapeksha	यांच्यापेक्षा	यांच्यापेक्षा

yanchyapramanech	यांच्याप्रमाणेच	यांच्याप्रमाणेच

yanchyabaddal	यांच्याबद्दल	यांच्याबद्दल

yanchyamadhye	यांच्यामध्ये	यांच्यामध्ये

yanchyamule	यांच्यामुळे	यांच्यामुळे

yanchyasathee	यांच्यासाठी	यांच्यासाठी

yanchyasathi	यांच्यासाठी	यांच्यासाठी

yanchyahee	यांच्याही	यांच्याही

yanchyahi	यांच्याही	यांच्याही

yanpasoon	यांपासून	यांपासून

yanpasun	यांपासून	यांपासून

yans	यानस	यांस

yaantargat	यांंतर्गत	याअंतर्गत

yanantargat	याननतर्गत	याअंतर्गत

yakade	याकडे	याकडे

yacha	याचा	याचा

yachach	याचाच	याचाच

yadnyik	याज्ञिक	याज्ञिक

yagyik	याज्ञिक	याज्ञिक

yadivashee	यादिवाी	यादिवशी

yadivashi	यादिवाी	यादिवशी

yaprakaarchay	याप्रकारच्	याप्रकारचे

yaprakaarche	याप्रकारचे	याप्रकारचे

yaprakarche	याप्रकररचे	याप्रकारचे

yaprakaarchya	याप्रकारच्या	याप्रकारच्या

yaprakarchya	याप्रकररच्या	याप्रकारच्या

yaprakaray	याप्रकारे	याप्रकारे

yaprakare	यापररकारे	याप्रकारे

yaas	यास	यास

yas	यास	यास

yaasi	यासी	यासी

yasee	यासी	यासी

yasi	यासी	यासी

euclid	एुक्लेड	युक्लीड

eucliid	एुक्लीड	युक्लीड

yuklid	एुक्लिद	युक्लीड

yukliid	एुक्लिड	युक्लीड

yuqlid	एुक्लिद	युक्लीड

unus	युन्स	युनूस

uunuus	युनूस	युनूस

yaanus	यानुस	युनूस

yaunis	युनिस	युनूस

yoonus	योनुस	युनूस

yoonuus	योनुस	युनूस

younis	योनिस	युनूस

youunis	योऊिस	युनूस

yunoos	युनुस	युनूस

yunus	युनुस	युनूस

yuunis	युनिस	युनूस

yuunus	युनुस	युनूस

yuunuus	युनुस	युनूस

yeiparyant	यापपर्यंत	येईपर्यंत

yeja	येजा	येजा

yenay	येणे	येणे

yene	येणे	येणे

yethe	येथे	येथे

yethey	येथे	येथे

yethahee	येथह	येथेही

yethayhi	येथाही	येथेही

yethehi	येथेही	येथेही

yeddoor	येददडूर	येळ्ळूर

yellur	येलररूर	येळ्ळूर

yeshil	येसील	येशिल

yojataat	योजतात	योजतात

yojatat	योजतात	योजतात

yojtaat	योजतात	योजतात

ranganath	रंगणाथ	रंगनाथ

rangavalele	रंगवलेले	रंगवलेले

rangavalelya	रंगवलेल्या	रंगवलेल्या

rakami	रामी	रकमी

rakmee	रा्ी	रकमी

raktadaan	रक्तदान	रक्तदान

raktadan	रक्ताान	रक्तदान

rakshanachi	रक्षणाची	रक्षणाची

raksha	रा्ष	रक्षा

rakshabandhan	रक्षबबंधन	रक्षाबंधन

raghupatee	रघुपती	रघुपती

raghupati	रघुपती	रघुपती

ran	रा	रण

ranathambor	रणथंबोर	रणथंबोर

ranthambor	रंथंबोर	रणथंबोर

ranbhoomeevar	राभूमीवर	रणभूमीवर

ranbhoomivar	राभूमीवर	रणभूमीवर

ranbhumivar	राभूमीवर	रणभूमीवर

raya	राा	रया

ravi	रवि	रवी

ravii	रवि	रवी

rawi	राि	रवी

ravind	रवींद	रवींद

rashhiyana	राियन	रशियन

rashiyan	राियन	रशियन

rashiyana	राियन	रशियन

rasiyana	रसियन	रशियन

ruchian	रुीयन	रशियन

rushhian	रसियन	रशियन

rushian	रसियन	रशियन

rusian	रसियन	रशियन

russian	रसियन	रशियन

rashhia	राीया	रशिया

rashhiaa	रािया	रशिया

rashhiya	रशिया	रशिया

rashhiyaa	रशिया	रशिया

rashia	राीया	रशिया

rashiaa	रािया	रशिया

rashiya	रशिया	रशिया

rashiyaa	रशिया	रशिया

rasia	रसिया	रशिया

rasiaa	रसिया	रशिया

rasiya	रसिया	रशिया

rasiyaa	रसिया	रशिया

rushshia	ऋुीया	रशिया

russia	ऋुिया	रशिया

rashiyat	राियात	रशियात

russiat	ऋुियात	रशियात

rashiyavar	राियावर	रशियावर

russiavar	रूिअावर	रशियावर

rasal	रसलल	रसाळ

rassa	रससश	रस्सा

rakheev	राखीव	राखीव

rakhiv	राखीव	राखीव

rajkiy	राजकीय	राजकिय

rajkiya	राजकीया	राजकिय

rajan	राजन	राजन

rajnath	राजनाथ	राजनाथ

rajasthanchee	राजस्थांची	राजस्थानची

rajasthanchi	राजस्थांची	राजस्थानची

rajasthanmadhye	राजा्थांाध्ये	राजस्थानमध्ये

rajasthanat	राजस्थानात	राजस्थानात

rajasthanatoon	राजस्थानातून	राजस्थानातून

rajasthanatun	राजस्थानातून	राजस्थानातून

rajasthanee	राजस्थानी	राजस्थानी

rajasthani	राजस्थानी	राजस्थानी

rajapoor	राजापूर	राजापूर

rajapur	राजापूर	राजापूर

rajoorkar	राजूरकर	राजूरकर

rajurkar	राजुरकर	राजूरकर

rajyabhar	राज्यभर	राज्यभर

rajyabharat	राज्यभरात	राज्यभरात

rajyabhishekachya	राज्याभिषेकाच्या	राज्याभिषेकाच्या

rajyabhishekanchya	राज्याभिषेकां्या	राज्याभिषेकाच्या

rajyabhishekanantar	राज्यभभिषेकारंतर	राज्याभिषेकानंतर

rajyabhishekannantar	राज्यभभिषेकारंतर	राज्याभिषेकानंतर

rajyabhishekala	राज्यभभिशेकाला	राज्याभिषेकाला

rajyamadhil	राज्यामधील	राज्यामधील

ranichi	राणीची	राणीची

ranichya	रणणीच्या	राणीच्या

raane	राणे	राने

rane	राणे	राने

ramapura	रामाूर	रामपूर

ramapuura	रामाूर	रामपूर

rampaar	रामपार	रामपूर

rampoor	रामपूर	रामपूर

rampur	रामपूर	रामपूर

rampuur	रामपूर	रामपूर

raalegao	राळेगाव	राळेगाव

radegaav	रादेगावा	राळेगाव

ralegao	राळेगाव	राळेगाव

ralegav	राळेगाव	राळेगाव

rashtray	राष्ट्राय	राष्ट्रिय

rashtriy	राष्ट्रीय	राष्ट्रिय

rashtriya	राष्ट्रीया	राष्ट्रिय

rahata	राहता	राहता

rahta	राहता	राहता

rahtaa	रहहता	राहता

rahilya	राहिल्या	राहिल्या

rahilyamuday	राहिल्यामुळे	राहिल्यामुळे

rahilyamule	राहिल्यामुळे	राहिल्यामुळे

reeka	रेका	रिका

reeqa	रेका	रिका

rica	रीका	रिका

riika	रीका	रिका

rika	रीका	रिका

riqa	रीका	रिका

rikamya	रिकाम्या	रिकाम्या

richards	रेचर्सस	रिचर्डस

reliance	रेलिंन्स	रिलायन्स

relief	रिल्फ	रिलीफ

relieph	रेल्फ	रिलीफ

reliief	रिल्फ	रिलीफ

riiliiph	रिल्फ	रिलीफ

rilif	रिलीफ	रिलीफ

riliph	रिलीफ	रिलीफ

relations	रेलेटन्स	रिलेशन्स

resource	रेसॉरचस	रिसोर्स

rudravatar	रुद्रावारर	रुद्रावतार

rudravtar	रुद्रावतरर	रुद्रावतार

rupayanchi	रुपयांची	रुपयांची

rupayanchya	रूपाांच्या	रुपयांच्या

rupyanchya	रूपयांच्या	रुपयांच्या

rupayant	रुपयंंत	रुपयांत

rupyant	रूपयंंत	रुपयांत

rusava	रुसा	रुसवा

rusva	रूस्ा	रुसवा

raani	रानी	रूनी

roonee	रोनी	रूनी

rooney	रोनी	रूनी

rooni	रुनी	रूनी

roonii	रोनी	रूनी

runee	रुनी	रूनी

runei	रुनी	रूनी

runey	रुने	रूनी

runi	रुनी	रूनी

runii	ऋुनी	रूनी

ruuney	रूनी	रूनी

ruuni	ऋूनी	रूनी

roopaye	रूपाे	रूपये

rupaye	रुपये	रूपये

rekhataat	रेखाटा	रेखाटतात

rekhatat	रेखाटत	रेखाटतात

rekhatatat	रेखाटतात	रेखाटतात

rekhattat	रेखाटतात	रेखाटतात

reghotya	रेघोट्या	रेघोट्या

raincoat	रेन्ाट	रेनकोट

raincoet	रेन्ोट	रेनकोट

raincooat	रें्ोट	रेनकोट

rainkoat	रेंकोट	रेनकोट

rainkoet	रेंकोट	रेनकोट

rainkooat	रें्ोट	रेनकोट

rainqoat	रें्ोट	रेनकोट

reenakot	रेणकोट	रेनकोट

reencoat	रें्ाट	रेनकोट

reenkot	रें्ॉट	रेनकोट

renakoot	रेणकोट	रेनकोट

renakot	रेणकोट	रेनकोट

renaqot	रेणकोट	रेनकोट

rencoat	रेण्ॉट	रेनकोट

rencoet	रेण्ॉट	रेनकोट

rencooat	रेन्ोट	रेनकोट

renkoat	रेंकॉट	रेनकोट

renkoot	रेंकोट	रेनकोट

renkot	रेंकोट	रेनकोट

renqot	रें्ोट	रेनकोट

reverand	रावरहरंड	रेव्हरंड

reverend	रावेहरेड	रेव्हरंड

revharand	रेव्हरंद	रेव्हरंड

revhrand	रेव्हरंद	रेव्हरंड

revrand	रेवरररंड	रेव्हरंड

reshamee	रेशाी	रेशमी

reshami	रेशमी	रेशमी

reshmee	रेश्ी	रेशमी

reesideent	रेसिडेंट	रेसिडेंट

resident	रेसिडेंट	रेसिडेंट

residentt	रेसिडेंट	रेसिडेंट

rezident	रेझिडेंट	रेसिडेंट

rahan	रहहणण	रेहान

rehan	रेहनन	रेहान

roostoov	रोस्टू	रोस्तोव

rostov	रोस्टो	रोस्तोव

rostow	रोस्टो	रोस्तोव

rohan	रोहा	रोहन

rohana	रोहा	रोहन

roohan	रोहा	रोहन

roohana	रोहा	रोहन

rohile	रोहिले	रोहिले

rohiley	रोहिले	रोहिले

haars	ह्सास	र्हास

hars	ह्सास	र्हास

has	ह	र्हास

horse	होहोसी	र्हास

laksh	लक्ष	लक्ष

laksha	ला्ष	लक्ष

lakshanancha	लक्षणांचा	लक्षणांचा

lakshananchee	लक्षणांची	लक्षणांची

lakshananchi	लक्षणांची	लक्षणांची

lakshananmadhye	लक्षणांमध्ये	लक्षणांमध्ये

lakshahi	लक्षाी	लक्षही

lakshun	लक्षून	लक्षून

lakshminagar	ला्ष्मीनगर	लक्ष्मीनगर

laxminagar	लक्ष्मीनगर	लक्ष्मीनगर

lagatcha	लगतचा	लगतचा

lagatche	लगतचे	लगतचे

lagatchey	लगतचे	लगतचे

laththapana	लथ्थपणा	लठ्ठपणा

latthapana	ला्थपणा	लठ्ठपणा

latthpana	ला्थपणा	लठ्ठपणा

ladh	लढ	लढ

ladha	लढा	लढ

ladhala	लढला	लढला

ladhla	लढला	लढला

ladhalya	लढल्या	लढल्या

ladhlya	लढल्या	लढल्या

ladhay	लढा	लढे

ladhe	लढे	लढे

lavasa	लासस	लवासा

lavasaa	लाससा	लवासा

lavh	ला	लव्ह

love	लाोहे	लव्ह

lavhadee	लव्हाडी	लव्हाळी

lavhadi	ला्हाडी	लव्हाळी

lavhali	ला्हाली	लव्हाळी

lashkarache	ला्कराचे	लष्कराचे

lashkarachey	ला्कराचे	लष्कराचे

lashkarachya	ला्कराच्या	लष्कराच्या

lashkaratoon	ला्करातून	लष्करातून

lashkaratun	ला्करातून	लष्करातून

lashkaravar	ला्करावर	लष्करावर

lashkaraver	ला्करावर	लष्करावर

lashkarawer	ला्करावर	लष्करावर

lashkarvar	ला्करववर	लष्करावर

lagato	लागतो	लागतो

lagto	लागतो	लागतो

lagavadicha	लगगवडीचा	लागवडीचा

lagvadicha	लगगवडीचा	लागवडीचा

lagavadichi	लगगवाीची	लागवडीची

lagvadichi	लागवाीची	लागवडीची

laatet	लाटेत	लाटेत

latet	लॅटेत	लाटेत

laal	लाल	लाल

lal	लाल	लाल

lala	लाला	लाल

laloo	लालू	लालू

laloon	लालून	लालू

lavanyacha	लावण्याचा	लावण्याचा

lavanyachs	लावण्याचं	लावण्याचा

lavnyacha	लावण्याचा	लावण्याचा

lavanyachee	लावण्याची	लावण्याची

lavanyachi	लावण्याची	लावण्याची

lavnyachee	लावण्याची	लावण्याची

lavanyachya	लावण्याच्या	लावण्याच्या

lavnyachya	लावण्याच्या	लावण्याच्या

laavnyaat	लावण्यात	लावण्यात

lavanyat	लावण्यात	लावण्यात

lavnyat	लावण्यात	लावण्यात

lavanyasathee	लावण्यासाठी	लावण्यासाठी

lavanyasathi	लावण्यासाठी	लावण्यासाठी

lavnyasathee	लावण्यासाठी	लावण्यासाठी

leenks	लिंक्स	लिंक्स

leenqs	लिंक्स	लिंक्स

liinks	लिंक्स	लिंक्स

lincs	लिंस्स	लिंक्स

links	लिंक्स	लिंक्स

linqs	लिंक्स	लिंक्स

linx	लिंक	लिंक्स

lynks	लिंक्स	लिंक्स

lynqs	लिंक्स	लिंक्स

limbale	लिंबलले	लिंबाळे

leara	लीरा	लिरा

leera	लेरा	लिरा

lera	लेरा	लिरा

liira	लीरा	लिरा

lira	लारा	लिरा

lihaava	लिहावा	लिहावा

lihava	लिहावा	लिहावा

lihito	लिहीतो	लिहितो

lay	लय	ले

le	ले	ले

ley	ले	ले

lekh	लेख	लेख

lekhamala	लेखमाला	लेखमाला

lekhmaala	लेखमाला	लेखमाला

lekhmala	लेखमाला	लेखमाला

lekhale	लेखले	लेखले

lekhle	लेखले	लेखले

lekhley	लेखले	लेखले

lekhaanchee	लेखांची	लेखांची

lekhanchi	लेखांची	लेखांची

lekhanmadhye	लेखांमध्ये	लेखांमध्ये

lekhacha	लेखाचा	लेखाचा

lekhache	लेखाचे	लेखाचे

lekhat	लेखटत	लेखात

lekhateel	लेखातील	लेखातील

lekhatil	लेखातील	लेखातील

lene	लेणे	लेणे

loid	लॉईड	लॉइड

loids	लॉईड	लॉइड

lawyer	लावर	लॉयर

loyar	लोयर	लॉयर

las	लास	लॉस

lass	लास	लॉस

laus	लास	लॉस

laush	लुस	लॉस

lauss	लास	लॉस

los	लोस	लॉस

losh	लोस	लॉस

loshsh	लोस	लॉस

loss	लॉस	लॉस

lokakalechhya	लोककलेच्या	लोककलेच्या

lokakalechya	लोककलेच्या	लोककलेच्या

lokkalechya	लोककलेच्या	लोककलेच्या

lokaparampara	लोकपरमपर	लोकपरंपरा

lokparampara	लोकपरमपर	लोकपरंपरा

lokamanasat	लोकमानाात	लोकमानसात

lokmanasat	लोकमानाात	लोकमानसात

local	लोकल	लोकल

lokal	लोकल	लोकल

loocal	लुकल	लोकल

lookal	लुकल	लोकल

loqal	लोकल	लोकल

localne	लोकलाे	लोकलने

lokalane	लोकलाे	लोकलने

loksabhechee	लोकसभेची	लोकसभेची

loksabhechi	लोकसभेची	लोकसभेची

loksabheche	लोकसभेचे	लोकसभेचे

loksabhechey	लोकसभेचे	लोकसभेचे

loksabhet	लोकसभेत	लोकसभेत

loksabheteel	लोकसभेतील	लोकसभेतील

loksabhetil	लोकसभेतील	लोकसभेतील

lokanunay	लोकानुये	लोकानुनय

lokanunaya	लोकानुया	लोकानुनय

lokashray	लोकशशररे	लोकाश्रय

lokopayogee	लोकोपाोगी	लोकोपयोगी

lokopayogi	लोकोपाोगी	लोकोपयोगी

lokopyogee	लोकोपीोगी	लोकोपयोगी

lote	लोट	लोटे

loan	लोण	लोण

lon	लोण	लोण

vakilanchya	वकिलांच्या	वकिलांच्या

vakilanna	वकिलांना	वकिलांना

vakilannee	वकिलांनी	वकिलांनी

vakilas	वकिलास	वकिलास

vakr	वक्र	वक्र

vakra	वकररा	वक्र

vajra	वारर	वज्र

vadhoocha	वाूचा	वधूचा

vadhucha	वाूचा	वधूचा

vadhoochya	वाूच्या	वधूच्या

vadhuchya	वाुच्या	वधूच्या

vanaushadhi	वनौषाी	वनौषधी

vanoushadhi	वनौषाी	वनौषधी

vayat	वातत	वयात

varishtha	वरीष्ठ	वरिष्ठ

varishthankade	वरीष्ठांकडे	वरिष्ठांकडे

varishthanna	वरिष्ठांना	वरिष्ठांना

vareelpramane	वरीलप्रमाणे	वरीलप्रमाणे

varilpramane	वरिल््रमाणे	वरीलप्रमाणे

vargamool	वर्गमूल	वर्गमूळ

vargmool	वर्गमुल	वर्गमूळ

vargmul	वर्गुुल	वर्गमूळ

vartamanpatra	वर्तमानपत्र	वर्तमानपत्र

vartmanpatra	वर्तमानपत्र	वर्तमानपत्र

vartamanpatrat	वर्तमानपत्रात	वर्तमानपत्रात

vartmanpatrat	वर्तमानपत्रात	वर्तमानपत्रात

vartamanpatrateel	वर्तमानपत्रातील	वर्तमानपत्रातील

vartamanpatratil	वर्तमांपत्रातील	वर्तमानपत्रातील

vartmanpatratil	वर्तमांपत्रातील	वर्तमानपत्रातील

vartamanpatratoon	वर्तमानपत्रातून	वर्तमानपत्रातून

vartamanpatratun	वर्तमानपत्रातून	वर्तमानपत्रातून

vartmanpatratun	वर्तमानपत्रातून	वर्तमानपत्रातून

varth	वर्थ	वर्थ

worth	वो्थ	वर्थ

varld	वर्ल	वर्ल्ड

vorld	वर्लदड	वर्ल्ड

warld	वर्ल	वर्ल्ड

world	वर्लदड	वर्ल्ड

varshanchee	वर्षांची	वर्षांची

varshanchi	वर्षांची	वर्षांची

varshanteel	वर्षांतील	वर्षांतील

varshantil	वर्षांतील	वर्षांतील

varshannantar	वर्षांनंतर	वर्षांनंतर

varshannatar	वर्षांनातर	वर्षांनंतर

varshanparyant	वर्षांपर्यंत	वर्षांपर्यंत

varshanpasoon	वर्षांपासून	वर्षांपासून

varshanpasun	वर्षांपासून	वर्षांपासून

varshanpeksha	वर्षांपेक्षा	वर्षांपेक्षा

varshansathee	वर्षांसाठी	वर्षांसाठी

varshansathi	वर्षांसाठी	वर्षांसाठी

varshanhoon	वर्षांहून	वर्षांहून

varshanhun	वर्षांहून	वर्षांहून

varshani	वर्षांी	वर्षानी

varshech	वर्षेच	वर्षेच

varsheparyant	वर्षेपर्यंत	वर्षेपर्यंत

varsheparyanta	वर्षेपर्यंत	वर्षेपर्यंत

valanare	वळणारे	वळणारे

valnare	वाणारे	वळणारे

valane	वाणे	वळणे

valne	वाणे	वळणे

valave	वाववे	वळावे

vasishth	वसिष्ठ	वसिष्ठ

vasishtha	वसिष्ठ	वसिष्ठ

vasundhara	वसुंधरा	वसुंधरा

vastutah	वस्तुतह	वस्तुतः

vastutaha	वस्तुतह	वस्तुतः

vastuman	वस्तूमान	वस्तुमान

vastoonee	वस्तूननी	वस्तूंनी

vastoonnee	वस्तूंनी	वस्तूंनी

vastoochya	वस्तूच्या	वस्तूच्या

vastuchya	वस्तूच्या	वस्तूच्या

vastoopasoon	वस्तूपासून	वस्तूपासून

vastupasun	वस्तूपासून	वस्तूपासून

vastoola	वस्तूला	वस्तूला

wastula	वस्तुला	वस्तूला

vastoovar	वस्तूवर	वस्तूवर

vastuvar	वस्तूवर	वस्तूवर

vastraharan	वस्त्रहरण	वस्त्रहरण

vaiche	वैईचे	वाईचे

vaiiche	वाईचे	वाईचे

vaiiteel	वैईटील	वाईतील

vaiteel	वैईतील	वाईतील

vaitil	वैईतील	वाईतील

vakprachar	वककपपररचार	वाक्प्रचार

vaganook	वगगणूक	वागणूक

vagnook	वगगणूक	वागणूक

vagnuk	वगगणूक	वागणूक

vagato	वगगतो	वागतो

vagto	वागतो	वागतो

vachal	वाचलल	वाचाल

vajantree	वाजनत्री	वाजंत्री

vajantri	वाजंत्री	वाजंत्री

vatave	वाटाे	वाटवे

vatve	वाटवे	वाटवे

vatecha	वाटेचा	वाटेचा

vatetil	वाटेतील	वाटेतील

vaadekar	वाडेकर	वाडेकर

vadekar	वाडेकर	वाडेकर

vadhatach	वाढतच	वाढतच

vadhatch	वाढतच	वाढतच

vadhavila	वाढविला	वाढविला

vadhvila	वाढविला	वाढविला

vadyanch	वाद्यांचं	वाद्यांचा

vadyancha	वाड्यांचा	वाद्यांचा

vadyanchya	वाद्यांच्या	वाद्यांच्या

vadyanna	वाद्यांना	वाद्यांना

vadyachi	वाड्याची	वाद्याची

vapar	वापर	वापर

vaparata	वापरता	वापरता

vaparta	वापर्ा	वापरता

vaparache	वापराचे	वापराचे

vaparat	वापरात	वापरात

vaparatoon	वापरातून	वापरातून

vaparatun	वापरातून	वापरातून

vaparane	वापरणने	वापराने

vaaprawar	वापरावर	वापरावर

vaparavar	वापरावर	वापरावर

vaapras	वापरास	वापरास

vaparas	वापरास	वापरास

vaaprasaathi	वापरासाठी	वापरासाठी

vaparasathi	वापरासाठी	वापरासाठी

vaam	वूम्	वाम

vam	वाम	वाम

waam	वाम	वाम

vaarna	वारणा	वारणा

varana	वररणा	वारणा

varna	वररणा	वारणा

vurna	वरर्ा	वारणा

warana	वररणा	वारणा

warna	वरर्ा	वारणा

wurna	वरर्ा	वारणा

varyacha	वरर्याचा	वाऱ्याचा

varyachya	वरर्याच्या	वाऱ्याच्या

varyane	वार्याने	वाऱ्याने

varyamule	वरर्यामुळे	वाऱ्यामुळे

valchandnagar	वाळचंदनार	वालचंदनगर

walchandnagar	वालचंदनार	वालचंदनगर

vasavaroon	वससावरून	वासावरून

vasavarun	वससावरून	वासावरून

vasoo	वासू	वासू

vasu	वासू	वासू

vastu	वसस्तू	वास्तु

vahatukichi	वाहतूकीची	वाहतुकीची

vahtukeechee	वाहतूकीची	वाहतुकीची

vahtukichi	वाहतूकीची	वाहतुकीची

vahatukit	वाहतूकीत	वाहतुकीत

vahtukeet	वाहतूकीत	वाहतुकीत

vahtukit	वाहतूकीत	वाहतुकीत

vikanyaachi	विकण्याची	विकण्याची

viknyachee	विकण्याची	विकण्याची

viknyachi	विकण्याची	विकण्याची

vikanyachya	विका्याच्या	विकण्याच्या

viknyachya	विकण्याच्या	विकण्याच्या

vikata	विकता	विकता

vikta	विक्ा	विकता

vikala	विकला	विकला

vikla	विकला	विकला

vikale	विकले	विकले

vikle	विकले	विकले

vikalp	विकल्प	विकल्प

vichaarto	विचारतो	विचारतो

vicharato	विचारतो	विचारतो

vicharto	विचारतो	विचारतो

vichaardharechey	विचारधररेचे	विचारधारेचे

vichardhareche	विचारधररेचे	विचारधारेचे

vijayavada	विजयवादा	विजयवाडा

vijayawada	विजयवादा	विजयवाडा

vijayvada	विजयवादा	विजयवाडा

vijaywada	विजयवादा	विजयवाडा

vizayavada	विजयवादा	विजयवाडा

vizayvada	विजयवादा	विजयवाडा

vizaywada	विजयवादा	विजयवाडा

wijayawada	विजयवादा	विजयवाडा

wijaywada	विजयवादा	विजयवाडा

vidnyanat	विज्ञानात	विज्ञानात

vigyanaat	विज्ञानात	विज्ञानात

vijhoon	विघून	विझून

vijhun	विघून	विझून

vizun	विजून	विझून

vitancha	वितांचा	विटांचा

vitanchya	वितांच्या	विटांच्या

vithabai	विठाबाई	विठाबाई

vidarbh	विदर्भ	विदर्भ

viddarbh	विदर्भर	विदर्भ

veedya	विड्या	विद्या

vidya	विड्य	विद्या

viidya	विड्या	विद्या

weedya	विड्या	विद्या

widya	विड्या	विद्या

vidyancha	विद्यांचा	विद्यांचा

vidyarthineela	विद्यार्थीनीला	विद्यार्थिनीला

vidyarthinila	विद्यार्थीनीला	विद्यार्थिनीला

vidyala	विद्याला	विद्याला

vidheyak	विधेकक	विधेयक

vidheyakala	विधेयकलला	विधेयकाला

vinamratene	विना्राेने	विनम्रतेने

vinaadathala	विनाददथळा	विनाअडथळा

vinaadthala	विनाददथा	विनाअडथळा

vineeta	विनिता	विनीता

vinita	विनिता	विनीता

veefal	वफफल	विफल

vifal	विफल	विफल

viphal	विफळ	विफल

veebhagla	विभागला	विभागला

vibhagala	विभागला	विभागला

veebhagli	विभागली	विभागली

vibhagalee	विभागली	विभागली

vibhagali	विभागली	विभागली

vibhagalya	विभागल्या	विभागल्या

vibhagahee	विभागही	विभागही

vibhagahi	विभागही	विभागही

vibhagancha	विभागांचा	विभागांचा

vibhaganchya	विभागांच्या	विभागांच्या

vibhaganna	विभागांना	विभागांना

vibhagakade	विभागाडडे	विभागाकडे

vibhagacha	विभागाचा	विभागाचा

vibhagachee	विभागाची	विभागाची

vibhagachi	विभागाची	विभागाची

vibhagache	विभागाचे	विभागाचे

vibhagane	विभागाने	विभागाने

vibhagashee	विभागाशी	विभागाशी

vibhagashi	विभागाशी	विभागाशी

vibhagasathi	विभागासाठी	विभागासाठी

vibhagiy	विभागीय	विभागीय

vibhagiya	विभागिय	विभागीय

veeranguda	विरंगुदा	विरंगुळा

virangula	विरंगुला	विरंगुळा

veerodhkanchya	विरोधकांच्या	विरोधकांच्या

virodhakanchya	विरोधकांच्या	विरोधकांच्या

virodhkanchya	विरोधकांच्या	विरोधकांच्या

vilay	विला	विलय

vealis	विल्श	विलिस

vilis	विलिश	विलिस

wealis	विल्श	विलिस

welis	वेलिश	विलिस

wilis	विलिश	विलिस

vishayak	विषयक	विषयक

vishayavar	विषयावर	विषयावर

vishayavarachee	विषयावराी	विषयावरची

vishayavarachi	विषयावराी	विषयावरची

vishayavarchi	विषयावरची	विषयावरची

vishayeechee	विषयीची	विषयीची

vishayichi	विषयीची	विषयीची

vishanoonchee	विशांूंची	विषाणूंची

vishanunchee	विशाणूंची	विषाणूंची

vishanunchi	विषांूंची	विषाणूंची

vishanoonchya	विशांूंच्या	विषाणूंच्या

vishanunchya	विषांूंच्या	विषाणूंच्या

vishanoocha	विषाणूचा	विषाणूचा

vishanucha	विषांूचा	विषाणूचा

vishanoochya	विषाणूच्या	विषाणूच्या

vishanuchya	विषांूच्या	विषाणूच्या

vishanoomule	विषाणूमुळे	विषाणूमुळे

vishanumule	विषाणुमुळे	विषाणूमुळे

vihangam	विहंगा	विहंगम

veehar	विहार	विहार

vihar	विहार	विहार

vihara	विहररा	विहार

viihar	विहार	विहार

weehar	विहार	विहार

wihar	विहार	विहार

wihara	विहररा	विहार

viharee	विहारी	विहारी

vihari	विहारी	विहारी

veej	विज	वीज

vij	विज	वीज

weej	विज	वीज

veeta	विता	वीटा

vita	विता	वीटा

veesek	विसिक	वीसेक

visek	विसिक	वीसेक

vrushan	वृषा	वृषण

vengurla	व्ंगुरलला	वेंगुर्ला

vegalee	वेगळी	वेगळी

vegaleech	वेगळीच	वेगळीच

vede	वेदे	वेडे

venoo	व्नू	वेणू

vedana	वेदाा	वेदना

vedna	वेद्ा	वेदना

vedanamay	वेदाामा	वेदनामय

vednamay	वेदनामा	वेदनामय

vellor	वेलरररर	वेल्लोर

vellore	वेलरररर	वेल्लोर

vaitarana	वैतरण	वैतरणा

vaitarna	वैतर्ा	वैतरणा

vainshapayan	वैनापययन	वैशंपायन

vaishanpayan	वैशापययन	वैशंपायन

vaishpayan	वैशपय	वैशंपायन

vyangya	व्याग्य	व्यंग्य

vyavasthapan	व्यवस्थापन	व्यवस्थापन

vyvasthapan	व्यवस्थापन	व्यवस्थापन

vyavasthapanachi	व्यवस्थापनाची	व्यवस्थापनाची

vyvasthapanachi	व्यवस्थापनाची	व्यवस्थापनाची

vyavastapanachya	व्यवस्तापनाच्या	व्यवस्थापनाच्या

vyavasthapanachya	व्यवस्थापनाच्या	व्यवस्थापनाच्या

vyvasthapanachya	व्यवस्थापनाच्या	व्यवस्थापनाच्या

vyavasthapanatil	व्यवस्थापनातील	व्यवस्थापनातील

vyvasthapanatil	व्यवस्थापनातील	व्यवस्थापनातील

vyavasthapanane	व्यवस्थापनाने	व्यवस्थापनाने

vyvasthapanane	व्यवस्थापनाने	व्यवस्थापनाने

vyavasthapanamadhye	व्यवस्थापनामध्ये	व्यवस्थापनामध्ये

vyavsthapanamadhye	व्यवस्थापनामध्ये	व्यवस्थापनामध्ये

vyvasthapanamadhe	व्यवस्थापनामध्ये	व्यवस्थापनामध्ये

vyavasthapanavar	व्यवस्थापाावर	व्यवस्थापनावर

vyavsthapanavar	व्यवस्थापाावर	व्यवस्थापनावर

vyvasthapanavar	व्यवस्थापनावर	व्यवस्थापनावर

vyavasthapanasathi	व्यवस्थापनासाठी	व्यवस्थापनासाठी

vyavsthapanasathee	व्यवस्थापनासाठी	व्यवस्थापनासाठी

vyvasthapanasaathi	व्यवस्थापनासाठी	व्यवस्थापनासाठी

vyavasthit	व्यवस्थित	व्यवस्थीत

vyavstheet	व्यवस्थित	व्यवस्थीत

vyvasthit	व्यवस्थित	व्यवस्थीत

vyavasthechya	व्यवस्थेच्या	व्यवस्थेच्या

vyavsthechya	व्यवस्थेच्या	व्यवस्थेच्या

vyavasthetil	व्यवस्थेतील	व्यवस्थेतील

vyavstheteel	व्यवस्थेतील	व्यवस्थेतील

vyavasthemule	व्यवस्थेमुळे	व्यवस्थेमुळे

vyavsthemule	व्यवस्थेमुळे	व्यवस्थेमुळे

vyavasthela	व्यवस्थेला	व्यवस्थेला

vyavsthela	व्यवस्थेला	व्यवस्थेला

vyavasthevar	व्यवस्थेवर	व्यवस्थेवर

vyavsthevar	व्यवस्थेवर	व्यवस्थेवर

vyasanmuktee	व्यसं्ुक्ती	व्यसनमुक्ती

vyakhya	व्याख्या	व्याख्या

vyakhyan	व्यखख्यान	व्याख्यान

vyakhyana	व्याख्याना	व्याख्यानं

vyakhyanam	व्यखख्याना	व्याख्यानं

vyakhyann	व्यखख्यां	व्याख्यानं

vyakhyanacha	व्याख्यानाचा	व्याख्यानाचा

vyakhyanachya	व्याख्यानाच्या	व्याख्यानाच्या

vyakhyanasathee	व्याख्यांासाठी	व्याख्यानासाठी

vyakhyanasathi	व्याख्यांासाठी	व्याख्यानासाठी

vyapate	व्यापते	व्यापते

vyayamprakar	व्यायमं््रकार	व्यायामप्रकार

vheitnam	व्हिततनाम	व्हिएटनाम

vhiyatnam	व्हिएतन्म	व्हिएटनाम

vietman	विहिएत्	व्हिएटनाम

vheelar	व्हीलर	व्हीलर

wheelar	व्हेलर	व्हीलर

wheeler	व्हीलर	व्हीलर

shakanarya	शकनाऱ्या	शकणाऱ्या

shaknarya	शकनाऱ्या	शकणाऱ्या

shakalyane	शकल्याने	शकल्याने

shaklyane	शकल्याने	शकल्याने

shakalyas	शकल्यास	शकल्यास

shaklyas	शकल्यास	शकल्यास

shakel	शकेल	शकेल

shakya	शक्य	शक्य

shakyahi	शा्याी	शक्यही

shatapavali	शताावली	शतपावली

shatpavali	शत्ावली	शतपावली

shatpavli	शत्ावली	शतपावली

shabari	शबरी	शबरी

shabri	शब्ी	शबरी

shamichya	शाीच्या	शमीच्या

sart	सर्त	शर्ट

shart	सरतत	शर्ट

shhart	शा्ट	शर्ट

shhirt	शि्ट	शर्ट

shhurt	सू्ट	शर्ट

shirt	शि्त	शर्ट

shurt	सू्ट	शर्ट

sirt	सि्त	शर्ट

surt	सू्ट	शर्ट

shastrakriyechya	शा्त्रक्रियेच्या	शस्त्रक्रियेच्या

shastrakriyet	शा्त्रक्रियात	शस्त्रक्रियेत

shastrakriyenantar	शा्त्रक्रियेनंतर	शस्त्रक्रियेनंतर

shaharatach	शहरातच	शहरातच

shaharaathi	शहराथही	शहरातही

shaharatahee	शहरातही	शहरातही

shaharatahi	शहरातही	शहरातही

sanghai	सांघाई	शांघाय

sanghaiye	सांगाईे	शांघाय

sanghay	सांघाय	शांघाय

sanghaya	सांगाय	शांघाय

shaanghaya	शांगाय	शांघाय

shanghai	शांगाई	शांघाय

shanghaiye	शांगाईे	शांघाय

shanghay	शांघाय	शांघाय

shanghaya	शांगाय	शांघाय

shanghe	शांघे	शांघाय

shangheye	शांगेये	शांघाय

shanjhai	शांहाई	शांघाय

shanjhaiye	शांजाईे	शांघाय

shanjhay	शंंघाय	शांघाय

shanjhaya	शांजाय	शांघाय

shhanghai	शांगाई	शांघाय

shhanghaiye	शांगाईे	शांघाय

shhanghay	शानघ	शांघाय

shhanghaya	शाणगाय	शांघाय

shaakir	शाकीर	शाकीर

shakeer	शककीर	शाकीर

shaaduchya	शादूच्या	शाडूच्या

shadoochya	शददूच्या	शाडूच्या

shaaraja	शारजा	शारजा

sharaja	शररजा	शारजा

sharja	शरर्ा	शारजा

shasak	शासक	शासक

shasakannee	शासकांनी	शासकांनी

shasakanni	शासकांनी	शासकांनी

shahoonagar	शाहूनगर	शाहूनगर

shahunagar	शहहुनगर	शाहूनगर

shinde	शिंदे	शिंदे

shindenchya	सिंदेंच्या	शिंदेंच्या

shindene	शिंदेने	शिंदेने

sheeuar	शेअर	शिऊर

shioor	शोअर	शिऊर

shiuur	सूअर	शिऊर

shikkamortab	शिकमकममोर्टब	शिक्कामोर्तब

shikshan	शिक्षण	शिक्षण

shikshanach	शिक्षणा	शिक्षणच

shikshanapaddhatee	शिक्षणपद्धती	शिक्षणपद्धती

shikshanpaddhati	शिक्षणपद्धती	शिक्षणपद्धती

shikshanpadhati	शिक्षणपदाधीी	शिक्षणपद्धती

shikshanvishayak	शिक्षणविषयक	शिक्षणविषयक

shikshanavyavasthet	शिक्षणव्यवस्थेत	शिक्षणव्यवस्थेत

shikshanvyavasthet	शिक्षणव्यवस्थेत	शिक्षणव्यवस्थेत

sheekshanaacha	शिक्षणाचा	शिक्षणाचा

shikshanacha	शिक्षणाचा	शिक्षणाचा

sheekshanaachi	शिक्षणाची	शिक्षणाची

shikshanachi	शिक्षणाची	शिक्षणाची

sheekshanaache	शिक्षणाचे	शिक्षणाचे

shikshanache	शिक्षणाचे	शिक्षणाचे

sheekshanaat	शिक्षणात	शिक्षणात

shikshanat	शिक्षणात	शिक्षणात

sheekshanaatil	शिक्षणातील	शिक्षणातील

shikshanatil	शिक्षणातील	शिक्षणातील

sheekshanaane	शिक्षणाने	शिक्षणाने

shikshanane	शिक्षणाने	शिक्षणाने

sheekshanaabarobarach	शिक्षणाबरोबरच	शिक्षणाबरोबरच

shikshanabarobarach	शिक्षणाबरोबरच	शिक्षणाबरोबरच

sheekshanaamude	शिक्षणामुळे	शिक्षणामुळे

shikshanamule	शिक्षणामुळे	शिक्षणामुळे

sheekshecha	शिक्षेचा	शिक्षेचा

shikshecha	शिक्षेचा	शिक्षेचा

sheekshela	शिक्षेला	शिक्षेला

shikshela	शिक्षेला	शिक्षेला

shigela	शिगेला	शिगेला

shijavila	शिजविला	शिजविला

shiradhon	शिरधोन	शिरढोण

shirdhon	शिर्ोन	शिरढोण

shiromane	शिरोमाे	शिरोमणी

shiromanee	शिरोमाी	शिरोमणी

shiromani	शिरोमाी	शिरोमणी

shirolee	शिरोळी	शिरोली

shiroli	शिरोळी	शिरोली

shhilanga	शिलांग	शिलाँग

shhillong	शिल्ंग	शिलाँग

shilanga	शिलांग	शिलाँग

shillang	शिल्ंग	शिलाँग

shillong	शिल्ंग	शिलाँग

shilong	शिलोंग	शिलाँग

silanga	सिलांग	शिलाँग

sillong	सिल्ंग	शिलाँग

shilpakala	शिल्पकाा	शिल्पकला

shilpkala	शिल्पकाा	शिल्पकला

shivarampant	शिवरामपंत	शिवरामपंत

shivrampant	शिवरामंंत	शिवरामपंत

shivaray	शिवराय	शिवराय

shivray	शिवराय	शिवराय

shivarayancha	शिवरायांचा	शिवरायांचा

shivrayancha	शिवरायांचा	शिवरायांचा

shivarayanchi	शिवरायांची	शिवरायांची

shivrayanchi	शिवरायांची	शिवरायांची

shivarayanchya	शिवरायांच्या	शिवरायांच्या

shivrayanchya	शिवरायांच्या	शिवरायांच्या

shishn	शिष्न	शिश्न

shishr	शिष्र	शिश्न

sheet	शीट	शीट

shit	शीत	शीट

shukla	शुकलला	शुक्ला

shuddh	शुद्ध	शुद्घ

shuddha	शुद्ध	शुद्घ

shudgha	शुद्घ	शुद्घ

shares	शररर्स	शेअर्स

shears	शेरर्स	शेअर्स

shadenet	शददणेत	शेडनेट

shednet	शेदणेत	शेडनेट

shetamalachee	शेतमललचची	शेतमालाची

shetamalachi	शेतमललचची	शेतमालाची

shetmalachi	शेतमालाची	शेतमालाची

shetamalache	शेतमललचचे	शेतमालाचे

shetmalache	शेतमलळचचे	शेतमालाचे

shetatach	शेतातच	शेतातच

seffield	सॉफफल्ड	शेफील्ड

sephild	सेफलल	शेफील्ड

sheeffieeld	शिफफल्ड	शेफील्ड

sheephild	शिफलल	शेफील्ड

sheffield	शॉफफल्ड	शेफील्ड

sheffiield	शॉफफल्ड	शेफील्ड

shefild	शॉफिल्ड	शेफील्ड

shephiild	शेफिल	शेफील्ड

shephild	शेफलल	शेफील्ड

shephphield	शेफफल्ड	शेफील्ड

shheffield	शॉफफल्ड	शेफील्ड

shhephild	शेफलल	शेफील्ड

saron	सररनन	शेरॉन

seran	सेरणन	शेरॉन

sharan	शररणन	शेरॉन

sharon	सररनन	शेरॉन

sheeran	शिरणन	शेरॉन

sheran	शेरणन	शेरॉन

sheron	शररनन	शेरॉन

shharon	शरर	शेरॉन

shheran	शेरणन	शेरॉन

sail	सैल	शेल

sel	सेल	शेल

sell	सील	शेल

shail	शेल	शेल

sheel	शील	शेल

sheell	शील	शेल

shel	शेल	शेल

shell	शील	शेल

shhail	शेल	शेल

shhel	शील	शेल

shhell	शील	शेल

shok	शॉक	शोक

shobhane	शोभणे	शोभणे

shobhne	शोभणे	शोभणे

shobhoon	शोभून	शोभून

shobhun	शोभून	शोभून

shrikrishanachya	श्रीक्षणणाच्या	श्रीकृष्णाच्या

shrikrishnachya	श्रीकृष्णाच्या	श्रीकृष्णाच्या

shrikrushnachya	श्रीकृष्णाच्या	श्रीकृष्णाच्या

shrikrishanane	श्रीक्षणणाने	श्रीकृष्णाने

shrikrishnane	श्रीक्ष्णाने	श्रीकृष्णाने

shrikrushnane	श्रीकृष्णाने	श्रीकृष्णाने

shrirang	श्रीरंग	श्रीरंग

shhrooti	श्रूती	श्रुती

shhruti	श्रूती	श्रुती

shraati	श्राती	श्रुती

shrooti	श्रूती	श्रुती

shrootii	स्रूती	श्रुती

shruti	श्रृती	श्रुती

shrutii	श्रृती	श्रुती

srooti	सूरूती	श्रुती

sruti	सृरृती	श्रुती

sandavich	साडविच	सँडविच

sandawich	साडविच	सँडविच

sandvich	सॅड्िच	सँडविच

sandvitch	संव्ित	सँडविच

sandwich	सॅड्ीच	सँडविच

sandwitch	संड्ित	सँडविच

sankatancha	संकटनंचा	संकटांचा

sankatanna	संकटनंना	संकटांना

sankatachya	संकटचच्या	संकटाच्या

sankatamule	संकाममुळे	संकटामुळे

sankate	संकते	संकटे

sangrahan	संग्रहण	संग्रहण

sangrahalay	संग्रहालय	संग्रहालय

sangrahalayachee	संग्रहालयाची	संग्रहालयाची

sangrahalayachi	संग्रहालयाची	संग्रहालयाची

sangrahalayachya	संग्रहालयाच्या	संग्रहालयाच्या

sanghatak	संघटक	संघटक

sanchari	संचारी	संचारी

sampate	संपते	संपते

samnpavale	सासाले	संपवले

sampavale	संपलले	संपवले

sampavoon	संपवून	संपवून

sampadak	संपादक	संपादक

sampadakannee	संपकककांनी	संपादकांनी

sampadakanni	संपकककांनी	संपादकांनी

sampadakache	संपकदकाचे	संपादकाचे

sambandh	संबंध	संबंध

sambhandh	संभंध	संबंध

sambandhancha	संबंधांचा	संबंधांचा

sambhandhancha	संभंधांचा	संबंधांचा

sambandhanchee	संबंधांची	संबंधांची

sambandhanchi	संबंधांची	संबंधांची

sambhandhanchee	संभंधांची	संबंधांची

sambadhanna	संबाधा	संबंधांना

sambandhanna	संबंधांना	संबंधांना

sambhandhanna	संभंधांना	संबंधांना

sambadhanvar	संबाधारवर	संबंधांवर

sambandhanvar	संबंधारवर	संबंधांवर

sambadhachya	संबाधाच्या	संबंधाच्या

sambandhachya	संबंधाच्या	संबंधाच्या

sambadhatoon	संबाधूनून	संबंधातून

sambandhatoon	संबंधानून	संबंधातून

sambhandhatoon	संभंधानून	संबंधातून

sambhal	साभाळ	संभाल

sanyogane	सायोगाने	संयोगाने

sanyojak	संयोजक	संयोजक

sanvatsar	संवत्सा	संवत्सर

sanvatsaracha	संवत्सरचचा	संवत्सराचा

sanvedan	संवेदा	संवेदन

sanvedana	संवेदाा	संवेदना

sanvedananche	संवेदनांचे	संवेदनांचे

sanshodhak	संशोधक	संशोधक

sanshodhakancha	संशोधकांचा	संशोधकांचा

sanshodhakanche	संशोधकानचे	संशोधकांचे

sanshodhakanchya	संशोधकांच्या	संशोधकांच्या

sanshodhakanna	संशोधकांना	संशोधकांना

sanshodhakannee	संशोधकांनी	संशोधकांनी

sanshodhakanni	संशोधकांनी	संशोधकांनी

sanshodhakansathee	संशोधकांसाठी	संशोधकांसाठी

sanshodhakansathi	संशोधकांसाठी	संशोधकांसाठी

sansaar	संसार	संसार

sansar	संसरर	संसार

sanskaran	संस्करण	संस्करण

sanskaar	संस्कार	संस्कार

sanskar	संस्कार	संस्कार

sanskaaracha	संस्काराचा	संस्काराचा

sanskaracha	संस्काराचा	संस्काराचा

sanskareet	संस्कारीत	संस्कारित

sanskarit	संस्कारीत	संस्कारित

sansthekadoon	संस्थेकडून	संस्थेकडून

sansthekadun	संस्थेकडून	संस्थेकडून

sansthechee	संस्थेची	संस्थेची

sansthechi	संस्थेची	संस्थेची

sansthechya	संस्थेचाया	संस्थेच्या

sansthetoon	संस्थेतून	संस्थेतून

sansthetun	संस्थेतून	संस्थेतून

sansthene	संस्थेने	संस्थेने

sansthemadhye	संस्थेमध्ये	संस्थेमध्ये

sansthela	संस्थेला	संस्थेला

sanstheshi	संस्थेशी	संस्थेशी

sansthesaathi	संस्थेसाठी	संस्थेसाठी

sansthesathi	संस्थेसाठी	संस्थेसाठी

sakreeya	सक्रिय	सक्रीय

sakriy	सक्रिय	सक्रीय

sakriya	सा्रिय	सक्रीय

sakhal	सखल	सखल

sanavar	सनारर	सणवार

sanvar	सं्ार	सणवार

satarave	सतरावे	सतरावे

satrave	सारावे	सतरावे

satkarm	सत्का्म	सत्कर्म

satkar	सा्करर	सत्कार

sattechi	सट्तेची	सत्तेची

sattet	सत्तेत	सत्तेत

satyajeet	सत्यजीत	सत्यजीत

satyajit	सत्यजीत	सत्यजीत

satyamev	सत्यमेव	सत्यमेव

sanad	सनद	सनद

sanachya	सााच्या	सनाच्या

sanee	सेी	सनी

sani	साी	सनी

sanii	सेी	सनी

sunee	सुी	सनी

suni	सुी	सनी

sunii	सुी	सनी

sunni	सु्	सनी

sunnii	सु्	सनी

sunny	सु्	सनी

suny	सु्	सनी

sapshel	सा्ेल	सपशेल

special	स्िलल	सपशेल

sapteembar	सा्तींबर	सप्टेंबर

sapteembara	सा्टेंबर	सप्टेंबर

saptembar	सा्तेंबर	सप्टेंबर

saptembara	सा्टेंबर	सप्टेंबर

seepteembeer	सि्टेमबर	सप्टेंबर

septembar	सी्टेमबर	सप्टेंबर

september	सी्टेमबर	सप्टेंबर

shaptembar	शा्तेंबर	सप्टेंबर

shaptembara	शा्टेंबर	सप्टेंबर

sheptember	शॉ्टेंबर	सप्टेंबर

sabhasadakadun	सभासाकककडून	सभासदांकडून

sabhasadakdonn	सभासदककको्न	सभासदांकडून

sabhasadankadoon	सभासाांकडून	सभासदांकडून

sabhasadankadun	सभासाांकडून	सभासदांकडून

sabhasadancha	सभासदांचा	सभासदांचा

sabhasadanche	सभासदांचे	सभासदांचे

sabhasadanna	सभासदांना	सभासदांना

sabhasadannee	सभासदांनी	सभासदांनी

sabhasadanni	सभासदांनी	सभासदांनी

samabhuj	समभूज	समभुज

sambhuj	साभूज	समभुज

samayi	समाी	समयी

samlaingik	सालेंगिक	समलैंगिक

samlangik	सालांगिक	समलैंगिक

samasyecha	समस्येचा	समस्येचा

samasyevar	समस्येवर	समस्येवर

samajasudharak	समाजसुधारक	समाजसुधारक

samajsudharak	समाजसुधारक	समाजसुधारक

samikaran	समीकरण	समिकरण

samiti	समिती	समिति

samuhache	समूहाचे	समुहाचे

samuhateel	समूहातील	समुहातील

samuhatil	समूहातील	समुहातील

sarada	सरदा	सरडा

sarda	शरदा	सरडा

sardaranche	सरदारांचे	सरदारांचे

sardaranni	सरदररांनी	सरदारांनी

sardarane	सरदरराने	सरदाराने

sardarala	सरदाराला	सरदाराला

sardesai	सर्ेशाई	सरदेसाई

sarpanch	सर्ाच	सरपंच

sarpancha	सर्ाचा	सरपंच

saral	सरळ	सरल

saralata	सराता	सरलता

sarlata	सराता	सरलता

sarasavalee	सरसलवली	सरसावली

sarsavali	सरसावली	सरसावली

sarahadda	सरहद्द	सरहद्द

sarhadd	सरहद्द	सरहद्द

sarita	सीीता	सरिता

saroop	सरूप	सरूप

sarup	सरूप	सरूप

sardee	सरददी	सर्दी

sardi	सरडडी	सर्दी

sarvang	सर्वांग	सर्वांग

sarvangaane	सर्वांगाने	सर्वांगाने

sarvangane	सर्वांगाने	सर्वांगाने

sarvangavar	सर्वांगावर	सर्वांगावर

salagpane	साा्णे	सलगपणे

salameeveer	साामीररर	सलामीवीर

salamiveer	साामिररर	सलामीवीर

sashart	साा्ट	सशर्त

sasharta	सार्त	सशर्त

sase	ससे	ससे

sahakarya	सहकार्‍	सहकार्य

sahkarya	सहकार्‍	सहकार्य

sahkaryaache	सहकार्‍ाचे	सहकार्याचे

sahkaryache	सहकार्‍ाचे	सहकार्याचे

sahkaryatoon	सहकार्यातून	सहकार्यातून

sahkaryatun	सहकरर्यातून	सहकार्यातून

sahkaryane	सहकार्‍ाने	सहकार्याने

saharachya	सहरराच्या	सहाराच्या

sakuree	साकुरी	साकुरी

sakuri	साकुरी	साकुरी

sakeet	साकीत	साकेत

sakeeta	साकिता	साकेत

saket	साकेत	साकेत

saketa	साकतता	साकेत

saqet	साकेट	साकेत

saqeta	साकेता	साकेत

saj	सजज	साज

sajeshee	साजेशी	साजेशी

sajeshi	सजजेशी	साजेशी

sathye	साथ्ये	साठ्ये

sadya	सदद्या	साड्या

sadyanchee	सदद्यांची	साड्यांची

sadyanchi	सदद्यांची	साड्यांची

satpuda	सातपूदा	सातपुडा

sataryaat	सातार्यात	साताऱ्यात

sataryat	सातार्यात	साताऱ्यात

sato	सातो	सातो

satoo	सातू	सातो

seto	साटो	सातो

sadhanechee	साधनेची	साधनेची

sadhanechi	साधणेची	साधनेची

sadhnechee	साधनेची	साधनेची

sadhanet	साधनेत	साधनेत

sadhnet	साधनेत	साधनेत

sadhaneteel	साधनेतील	साधनेतील

sadhanetil	साधनेतील	साधनेतील

sadhneteel	साधणेतील	साधनेतील

sadhanene	साधनेने	साधनेने

saniya	सानिया	सानिया

sam	सॅम	साम

samajik	सामाजिक	सामाजिक

saynsache	संयन्साे	सायन्सचे

scienceche	सियन्सेे	सायन्सचे

sayansmadhye	सायन्ममध्ये	सायन्समध्ये

sciencemadhye	सियन्समध्ये	सायन्समध्ये

cybar	कायबर	सायबर

cyber	सायबर	सायबर

sayabara	सायबर	सायबर

saybar	सायबा	सायबर

shayabara	शायबर	सायबर

shyber	शायबर	सायबर

sybar	सायबर	सायबर

syber	सायबर	सायबर

sarakh	सारख	सारख

sarkh	सारख	सारख

saaran	सारण	सारण

saran	सररण	सारण

sarana	सररणा	सारण

shaaran	शारा	सारण

sharana	शरराा	सारण

sarani	सरराी	सारणी

sarni	सररणी	सारणी

sarbhut	सारभुत	सारभूत

saalunki	सुलुंकी	साळुंकी

salunki	सालुंकी	साळुंकी

savanga	सावंग	सावंगा

savar	सावर	सावर

savara	सावरा	सावर

sawar	सावर	सावर

sawara	सावरा	सावर

savarla	सावरला	सावरला

savrala	सावराा	सावरला

savali	सावळी	सावली

savli	सावळी	सावली

savalicha	सावळीचा	सावलीचा

savlicha	सावळीचा	सावलीचा

sasarche	सससरचे	सासरचे

sasaree	सासरी	सासरी

sasari	सासरी	सासरी

sasri	सससरी	सासरी

sasare	सासरे	सासरे

sasre	सासरे	सासरे

sasooche	सासूचे	सासूचे

sasuche	सासूचे	सासूचे

sahaskatha	सहहस्था	साहसकथा

sahebanchya	सहहेबांच्या	साहेबांच्या

sahebanna	साहेबांना	साहेबांना

sahebee	सहहेबी	साहेबी

sahebi	साहेबी	साहेबी

sing	सिंग	सिंग

singer	सिंगर	सिंगर

sigmand	सीग्माड	सिग्मंड

sigmond	सीग्मोड	सिग्मंड

citizen	सीटीजन	सिटीझन

siteejhan	सितीजा	सिटीझन

siddee	सिद्दी	सिद्दी

siddi	सिद्दी	सिद्दी

siddhantacha	सिद्धांतचचा	सिद्धांताचा

siddhantachee	सिद्धांतचची	सिद्धांताची

siddhantachi	सिद्धांतचची	सिद्धांताची

siddhantat	सिद्धांतात	सिद्धांतात

siddhantavar	सिद्धांतववर	सिद्धांतावर

siddhantawar	सिद्धांतववर	सिद्धांतावर

siva	शिवा	सिवा

seemit	सीमित	सीमित

simit	सीमित	सीमित

sundar	संंदर	सुंदर

sundarta	सुंदर्ा	सुंदरता

sukhavale	सुखववले	सुखावले

sukhavle	सुखववले	सुखावले

sujan	सुजा	सुजन

suzan	सुजं	सुजन

sujit	सुजीत	सुजित

suttee	सुट्टी	सुट्टी

sutti	सुट्टी	सुट्टी

sutteeche	सुटीटीचे	सुट्टीचे

suttiche	सूट्टीचे	सुट्टीचे

sutteechya	सुटीटीच्या	सुट्टीच्या

suttichya	सुट्टीच्या	सुट्टीच्या

sutteemadhye	सुटीटीमध्ये	सुट्टीमध्ये

suttimadhe	सुटीटीमध्ये	सुट्टीमध्ये

suttimadhye	सुटीटीमध्ये	सुट्टीमध्ये

sutache	सुटाचे	सुताचे

saadan	सादान	सुदान

soodan	सुदान	सुदान

sudaan	सुदान	सुदान

sudan	सुदान	सुदान

sudana	सुदान	सुदान

soodur	सूदूर	सुदूर

sudoor	सूदूर	सुदूर

sudur	सूदूर	सुदूर

sudradh	सुद्ढ	सुदृढ

sudrudh	सुद्ढ	सुदृढ

sudrudha	सुद्ढ	सुदृढ

sunavala	सुनावाा	सुनावला

sunavali	सुनावली	सुनावली

sunavale	सुनावले	सुनावले

supt	सूप्त	सुप्त

supta	सुपतत	सुप्त

sur	सरर	सुर

soorat	सुरत	सुरत

surat	सुरत	सुरत

surata	सुरता	सुरत

sureta	सुराा	सुरत

suratla	सुराला	सुरतला

suravatichya	सुरवततीच्या	सुरवातीच्या

survatichya	सुर्ततीच्या	सुरवातीच्या

survatipasun	सुर्ततीपासून	सुरवातीपासून

suranchi	सुरांची	सुरांची

suranchya	सुरांच्या	सुरांच्या

surya	सूर्य	सुर्या

suryachya	सूर्याच्या	सुर्याच्या

shooltan	शुल्ान	सुलतान

shulatan	शुलतान	सुलतान

sooltan	सुल्ान	सुलतान

sulatan	सुलॅान	सुलतान

sultan	सुल्ान	सुलतान

sultanannee	सुलतानांनी	सुलतानांनी

sultananni	सुलतानांनी	सुलतानांनी

sultanane	सुलतानाने	सुलतानाने

sultan	सुल्टनन	सुल्तान

suvarnakamal	सुवर्णकाळ	सुवर्णकमळ

suvarnkamal	सुवर्णकाळ	सुवर्णकमळ

suvarnamai	सुवर्णााा	सुवर्णमय

suvarnamay	सुवर्णाा	सुवर्णमय

suvarnmay	सुवर्णमय	सुवर्णमय

suvarnayog	सुवर्णयोग	सुवर्णयुग

suvarnayug	सुवर्णेुग	सुवर्णयुग

suvarnyug	सुवर्णिुग	सुवर्णयुग

suwarnayug	सुवर्णाुग	सुवर्णयुग

susanghatit	सुसंघाित	सुसंघटित

susanghtit	सुसंघीीत	सुसंघटित

susanskarit	सुसंस्कारीत	सुसंस्कारित

susajj	सुसझ्ज	सुसज्ज

susajja	सुसााजा	सुसज्ज

susvabhavee	सुसववाावी	सुस्वभावी

susvabhavi	सुवववाावी	सुस्वभावी

suryodayachi	सूर्योदााची	सूर्योदयाची

suryodayapasoon	सूर्योदाापासून	सूर्योदयापासून

suryodayapasun	सूर्योदाापासून	सूर्योदयापासून

sain	सेन	सॅन

san	सॅन	सॅन

sana	सॅन	सॅन

sen	सेन	सॅन

shain	सेन	सॅन

shan	सान	सॅन

shana	सॅन	सॅन

second	सेकंड	सेकंद

secondala	सेकंडाला	सेकंदाला

cellche	केलचे	सेलचे

saleche	साचचे	सेलचे

sellche	सेलचे	सेलचे

sevika	सेविका	सेविका

sainyasah	सैन्यससह	सैन्यासह

senyasaha	सैन्यससह	सैन्यासह

songatee	सोनगटी	सोंगटी

songati	सोंगती	सोंगटी

sonar	सोनरर	सोनार

sonara	सोनररा	सोनार

soonar	सुनरर	सोनार

soonara	सोनररा	सोनार

soap	सूप	सोप

sooap	सूप	सोप

soop	सूप	सोप

sop	सपप	सोप

sopaskar	सोपस्कार	सोपस्कार

sopi	सौपी	सोपी

sobateene	सोबतीने	सोबतीने

sobteene	सोबतीने	सोबतीने

sobtine	सोबतीने	सोबतीने

somnath	सोमनाथ	सोमनाथ

soviat	सोविहिएाट	सोव्हियेत

soviet	सोविहिएा	सोव्हियेत

social	सोसल	सोशल

saujanya	सौजन्य	सौजन्य

soajanya	सोजन्या	सौजन्य

saujanyane	सौजन्याने	सौजन्याने

scaaba	साकाबा	स्कुबा

scooba	स्कोबा	स्कुबा

scuba	स्कोबा	स्कुबा

skuba	स्कूबा	स्कुबा

squba	स्कूब	स्कुबा

stadiumchi	स्ताअीसाची	स्टेडियमची

stediyamchee	स्टेडियाची	स्टेडियमची

stationary	स्टेशनरी	स्टेशनरी

stationery	स्टेशनरी	स्टेशनरी

steshanaree	स्तेशनाी	स्टेशनरी

stutya	स्तुत्य	स्तुत्य

sthanikankadoon	स्थानिकांकडून	स्थानिकांकडून

sthanikankadun	स्थानिकांकडून	स्थानिकांकडून

sthaneekanna	स्थानिकांना	स्थानिकांना

sthanikanna	स्थानिकांना	स्थानिकांना

sthayibhaav	स्थायिभाव	स्थायीभाव

sthayibhav	स्थायिभाव	स्थायीभाव

stheet	स्थित	स्थित

sthit	स्थित	स्थित

spead	स्पीड	स्पीड

sped	स्पेड	स्पीड

speed	स्पेड	स्पीड

spid	स्पीड	स्पीड

spiid	स्पीड	स्पीड

spaem	स्पेम	स्पॅम

spam	स्पॅम	स्पॅम

sfatik	ए्फािक	स्फटिक

sphatik	स्फािक	स्फटिक

swatachich	स्वतचचीच	स्वतःचीच

swatahchich	स्वतचचिच	स्वतःचीच

svarupat	स्वरुपात	स्वरूपात

swarupat	स्वरुपात	स्वरूपात

svarupatale	स्वरूपातले	स्वरूपातले

swarupatale	स्वरूपातले	स्वरूपातले

svarupatahee	स्वरूपाठही	स्वरूपातही

svarupatahi	स्वरूपाठही	स्वरूपातही

swarupatahi	स्वरूपाठही	स्वरूपातही

swareecha	स्वररीचा	स्वारीचा

swaricha	स्वररीचा	स्वारीचा

swareet	स्वारीत	स्वारीत

swarit	स्वारीत	स्वारीत

sveeng	स्विंग	स्विंग

svin	स्वीनग	स्विंग

sving	स्विंग	स्विंग

sweeng	स्विंग	स्विंग

swiing	स्वींग	स्विंग

swin	स्वीनग	स्विंग

swing	स्विंग	स्विंग

switzerlandchi	स्वितेझरललादीी	स्वित्झर्लंडची

shveeft	स्विफ्ट	स्विफ्ट

shviphta	स्विफ्ट	स्विफ्ट

shweaft	स्विफ्ट	स्विफ्ट

shweeft	स्विफ्ट	स्विफ्ट

shwift	स्विफ्ट	स्विफ्ट

sveaft	स्विफ्ट	स्विफ्ट

sveeft	स्विफ्ट	स्विफ्ट

sveepht	स्विफ्ट	स्विफ्ट

svift	स्विफ्ट	स्विफ्ट

svifta	स्विफ्ट	स्विफ्ट

sviift	स्विफ्ट	स्विफ्ट

sviphta	स्विफ्ट	स्विफ्ट

sweaft	स्विफ्ट	स्विफ्ट

sweapht	स्वाफ्ट	स्विफ्ट

sweeft	स्विफ्ट	स्विफ्ट

sweepht	स्विफ्ट	स्विफ्ट

sweft	स्विफ्ट	स्विफ्ट

swift	स्विफ्ट	स्विफ्ट

swiift	स्विफ्ट	स्विफ्ट

swipht	स्विफ्ट	स्विफ्ट

swiphta	स्विफ्ट	स्विफ्ट

shveep	श्वीप	स्वीप

shvipa	स्विप	स्वीप

shweap	स्वीप	स्वीप

shweep	श्वीप	स्वीप

sveap	श्वीप	स्वीप

sveep	श्वीप	स्वीप

sviip	श्वीप	स्वीप

sviipa	स्विप	स्वीप

svipa	स्वीप	स्वीप

sweap	स्वीप	स्वीप

sweep	श्वीप	स्वीप

swep	स्वीप	स्वीप

swiip	स्वीप	स्वीप

swipa	स्वीप	स्वीप

handaseet	हंडसीत	हँडसेट

handaset	हंडसेत	हँडसेट

handseet	हंडसीत	हँडसेट

handset	हंडसेत	हँडसेट

hajaree	हजारी	हजारी

hajari	हजारी	हजारी

harananche	हराांचे	हरणांचे

harnanche	हर्ांचे	हरणांचे

harananchya	हराांच्या	हरणांच्या

harnanchya	हर्ांच्या	हरणांच्या

haranachya	हरणाच्या	हरणाच्या

harnachya	हरणाच्या	हरणाच्या

hari	हॅी	हरि

hariche	हरीचे	हरिचे

haree	हरे	हरी

hari	हॅी	हरी

harii	हॅी	हरी

hary	हॅ्	हरी

hurri	हरी	हरी

hurry	हरी	हरी

hury	हर्	हरी

hardikar	हर्डीकर	हर्डीकर

haladine	हलदीने	हळदीने

haldine	हलदीने	हळदीने

havyat	हव्यात	हव्यात

hasanyachya	हसण्याच्या	हसण्याच्या

hasnyachya	हसण्याच्या	हसण्याच्या

hast	हस्त	हस्त

haste	हसतते	हस्ते

hausache	हौऊचाे	हाऊसचे

houseche	हौऊसचे	हाऊसचे

hausachya	हौऊचा्या	हाऊसच्या

housechya	हौऊशच्या	हाऊसच्या

hatohat	हातोहात	हातोहात

harmonium	हरर्मोनियम	हार्मोनियम

harmoniyam	हरर्मोनियम	हार्मोनियम

harmoniyama	हरर्मोनियम	हार्मोनियम

harmoonium	हरर्मोनियम	हार्मोनियम

harmooniyama	हरर्मोनियम	हार्मोनियम

harmoniumvar	हरर्मोनियमार	हार्मोनियमवर

harmoniyamvar	हरर्मोनियारर	हार्मोनियमवर

hindavi	हिंदवी	हिंदवी

hindvi	हिंद्ी	हिंदवी

hindusthanat	हिंदुस्थानात	हिंदुस्थानात

hindusthanateel	हिंदुस्थानेतील	हिंदुस्थानातील

hindusthanatil	हिंदुस्थानेतील	हिंदुस्थानातील

hichyakade	हिच्याकडे	हिच्याकडे

hichyavar	हिच्यावर	हिच्यावर

hichyavr	हिच्यावर	हिच्यावर

heatlar	हेटलर	हिटलर

heatler	हेटलर	हिटलर

heetlar	हीटलर	हिटलर

heetler	हेटलर	हिटलर

hetler	हेटलर	हिटलर

hiitler	हीटलर	हिटलर

hitalar	हिटार	हिटलर

hitalara	हिटार	हिटलर

hitler	हीटलर	हिटलर

hittlar	हीट्र	हिटलर

hittler	हीट्र	हिटलर

hitalarachya	हितारच्या	हिटलरच्या

hitlerchya	हितलरच्या	हिटलरच्या

hitalarala	हितार्ा	हिटलरला

hitlerla	हिटलर्ा	हिटलरला

hitchintak	हिचचिंतक	हितचिंतक

hindoo	हिं्दू	हिन्दू

hindu	हिं्दू	हिन्दू

himalayacha	हिमालयाचा	हिमालयाचा

himalayachi	हिमालयाची	हिमालयाची

himalayachya	हिमालयाच्या	हिमालयाच्या

hiil	हील	हिल

hil	हिल	हिल

hill	हिल	हिल

hivalyateel	हिवाळ्यातील	हिवाळ्यातील

hivalyatil	हिवलळ्यातील	हिवाळ्यातील

heechee	हिची	हीची

heechi	हेची	हीची

hichi	हिची	हीची

hundaka	हंंडका	हुंदका

husharee	हुसररी	हुशारी

hushari	हुसारी	हुशारी

hushareene	हुसररीने	हुशारीने

husharine	हुसररीने	हुशारीने

hratik	ह्तिक	हृतिक

hritik	ऋृतिक	हृतिक

hrutik	ऋृतिक	हृतिक

hrishikesh	ऋृषिकेश	हृषिकेश

hrusheekesh	ऋृषेकेश	हृषिकेश

hrushikesh	ऋृषिकेश	हृषिकेश

hay	है	हे

he	है	हे

hei	हे	हे

hey	हे	हे

hetoone	हेतूने	हेतुने

hetune	हेतूने	हेतुने

herat	हेरतट	हेरात

harald	हॅराल्ड	हेराल्ड

haralda	हरराल्ड	हेराल्ड

heerald	हीरलल्ड	हेराल्ड

heeralda	हाराल्ड	हेराल्ड

herald	हरराल्ड	हेराल्ड

heralda	हरराल्ड	हेराल्ड

heroon	हेरून	हेरून

herun	हेरून	हेरून

hesuddha	हेसुद्ध	हेसुद्धा

haland	हललंड	हॉलंड

halland	हललाड	हॉलंड

hauland	होलाड	हॉलंड

holand	होलंड	हॉलंड

holland	होलंड	हॉलंड

ho	हो	हो

hoe	होई	हो

hoo	होओ	हो

hooe	होई	हो

hoowe	होव	हो

hove	होव	हो

howe	होव	हो

hotatach	होतातच	होतातच

hotee	होती	होती

hoti	होती	होती

homehavan	होमेवा	होमहवन

homhavan	होम्ाा	होमहवन

hyanchyateel	ह्यांच्यातील	ह्यांच्यातील

hyanchyatil	ह्यांच्यातील	ह्यांच्यातील

hyannee	ह्यांनी	ह्यांनी

hyanni	ह्यांनी	ह्यांनी

hyanneech	ह्यांनीच	ह्यांनीच

hyannich	ह्यांनीच	ह्यांनीच

